Yr,Player,Pos,Age,Tm,G,GS,MP,FG,FGA,FG%,3P,3PA,3P%,2P,2PA,2P%,eFG%,FT,FTA,FT%,ORB,DRB,TRB,AST,STL,BLK,TOV,PF,PTS
1980,Kareem Abdul-Jabbar*,C,32,LAL,82,,3143,835,1383,.604,0,1,.000,835,1382,.604,.604,364,476,.765,190,696,886,371,81,280,297,216,2034
1980,Tom Abernethy,PF,25,GSW,67,,1222,153,318,.481,0,1,.000,153,317,.483,.481,56,82,.683,62,129,191,87,35,12,39,118,362
1980,Alvan Adams,C,25,PHO,75,,2168,465,875,.531,0,2,.000,465,873,.533,.531,188,236,.797,158,451,609,322,108,55,218,237,1118
1980,Tiny Archibald*,PG,31,BOS,80,80,2864,383,794,.482,4,18,.222,379,776,.488,.485,361,435,.830,59,138,197,671,106,10,242,218,1131
1980,Dennis Awtrey,C,31,CHI,26,,560,27,60,.450,0,0,,27,60,.450,.450,32,50,.640,29,86,115,40,12,15,27,66,86
1980,Gus Bailey,SG,28,WSB,20,,180,16,35,.457,1,1,1.000,15,34,.441,.471,5,13,.385,6,22,28,26,7,4,11,18,38
1980,James Bailey,PF,22,SEA,67,,726,122,271,.450,0,0,,122,271,.450,.450,68,101,.673,71,126,197,28,21,54,79,116,312
1980,Greg Ballard,SF,25,WSB,82,,2438,545,1101,.495,16,47,.340,529,1054,.502,.502,171,227,.753,240,398,638,159,90,36,133,197,1277
1980,Mike Bantom,SF,28,IND,77,,2330,384,760,.505,1,3,.333,383,757,.506,.506,139,209,.665,192,264,456,279,85,49,189,268,908
1980,Marvin Barnes,PF,27,SDC,20,,287,24,60,.400,0,0,,24,60,.400,.400,16,32,.500,34,43,77,18,5,12,18,52,64
1980,Rick Barry*,SF,35,HOU,72,,1816,325,771,.422,73,221,.330,252,550,.458,.469,143,153,.935,53,183,236,268,80,28,152,182,866
1980,Tim Bassett,PF,28,TOT,12,,164,12,34,.353,0,0,,12,34,.353,.353,10,15,.667,11,22,33,14,8,0,9,27,34
1980,Tim Bassett,PF,28,NJN,7,,92,8,22,.364,0,0,,8,22,.364,.364,8,12,.667,7,11,18,4,5,0,4,14,24
1980,Tim Bassett,PF,28,SAS,5,,72,4,12,.333,0,0,,4,12,.333,.333,2,3,.667,4,11,15,10,3,0,5,13,10
1980,Billy Ray Bates,SG,23,POR,16,,235,72,146,.493,8,19,.421,64,127,.504,.521,28,39,.718,13,16,29,31,14,2,20,26,180
1980,Ron Behagen,PF,29,WSB,6,,64,9,23,.391,0,0,,9,23,.391,.391,5,6,.833,6,8,14,7,0,4,4,14,23
1980,Kent Benson,C,25,TOT,73,,1891,299,618,.484,1,5,.200,298,613,.486,.485,99,141,.702,126,327,453,178,73,92,157,246,698
1980,Kent Benson,C,25,MIL,56,,1389,213,431,.494,0,1,.000,213,430,.495,.494,66,97,.680,96,237,333,127,54,74,106,178,492
1980,Kent Benson,C,25,DET,17,,502,86,187,.460,1,4,.250,85,183,.464,.463,33,44,.750,30,90,120,51,19,18,51,68,206
1980,Del Beshore,PG,23,CHI,68,,869,88,250,.352,10,26,.385,78,224,.348,.372,58,87,.667,16,47,63,139,58,5,104,105,244
1980,Henry Bibby,PG,30,PHI,82,8,2035,251,626,.401,11,52,.212,240,574,.418,.410,226,286,.790,65,143,208,307,62,6,147,161,739
1980,Larry Bird*,PF,23,BOS,82,82,2955,693,1463,.474,58,143,.406,635,1320,.481,.494,301,360,.836,216,636,852,370,143,53,263,279,1745
1980,Otis Birdsong,SG,24,KCK,82,,2885,781,1546,.505,10,36,.278,771,1510,.511,.508,286,412,.694,170,161,331,202,136,22,179,226,1858
1980,Ron Boone,SG,33,TOT,81,,2392,405,915,.443,19,50,.380,386,865,.446,.453,175,196,.893,54,173,227,309,97,3,197,232,1004
1980,Ron Boone,SG,33,LAL,6,,106,14,40,.350,0,0,,14,40,.350,.350,6,7,.857,4,7,11,7,5,0,13,13,34
1980,Ron Boone,SG,33,UTA,75,,2286,391,875,.447,19,50,.380,372,825,.451,.458,169,189,.894,50,166,216,302,92,3,184,219,970
1980,Lawrence Boston,PF,23,WSB,13,,125,24,52,.462,0,0,,24,52,.462,.462,8,13,.615,19,20,39,2,4,2,8,25,56
1980,Tom Boswell,PF,26,TOT,79,,2077,346,613,.564,5,10,.500,341,603,.566,.569,206,273,.755,146,296,442,161,29,37,181,270,903
1980,Tom Boswell,PF,26,DEN,18,,522,72,135,.533,1,2,.500,71,133,.534,.537,58,70,.829,40,74,114,46,5,8,39,56,203
1980,Tom Boswell,PF,26,UTA,61,,1555,274,478,.573,4,8,.500,270,470,.574,.577,148,203,.729,106,222,328,115,24,29,142,214,700
1980,Winford Boynes,SG,22,NJN,64,,1102,221,467,.473,0,4,.000,221,463,.477,.473,104,136,.765,51,82,133,95,59,19,96,132,546
1980,Alonzo Bradley,SF,26,HOU,22,,96,17,48,.354,1,1,1.000,16,47,.340,.365,6,9,.667,2,4,6,3,3,0,8,9,41
1980,Dudley Bradley,SG,22,IND,82,,2027,275,609,.452,2,5,.400,273,604,.452,.453,136,174,.782,69,154,223,252,211,48,166,194,688
1980,Mike Bratz,PG,24,PHO,82,,1589,269,687,.392,21,86,.244,248,601,.413,.407,141,162,.870,50,117,167,223,93,9,135,165,700
1980,Jim Brewer,PF,28,POR,67,,1016,90,184,.489,0,5,.000,90,179,.503,.489,14,29,.483,101,156,257,75,42,43,47,129,194
1980,Ron Brewer,SG,24,POR,82,,2815,548,1182,.464,6,32,.188,542,1150,.471,.466,184,219,.840,54,160,214,216,98,48,167,154,1286
1980,Junior Bridgeman,SF,26,MIL,81,,2316,594,1243,.478,5,27,.185,589,1216,.484,.480,230,266,.865,104,197,301,237,94,20,172,216,1423
1980,Allan Bristow,SF,28,UTA,82,,2304,377,785,.480,2,7,.286,375,778,.482,.482,197,243,.811,170,342,512,341,88,6,179,211,953
1980,Fred Brown,SG,31,SEA,80,,1701,404,843,.479,39,88,.443,365,755,.483,.502,113,135,.837,35,120,155,174,65,17,105,117,960
1980,John Brown,SF,28,TOT,32,,385,37,105,.352,0,0,,37,105,.352,.352,38,48,.792,26,45,71,18,3,4,29,70,112
1980,John Brown,SF,28,UTA,4,,24,0,7,.000,0,0,,0,7,.000,.000,4,4,1.000,5,4,9,4,0,0,5,4,4
1980,John Brown,SF,28,ATL,28,,361,37,98,.378,0,0,,37,98,.378,.378,34,44,.773,21,41,62,14,3,4,24,66,108
1980,Roger Brown,C,29,CHI,4,,37,1,3,.333,0,0,,1,3,.333,.333,0,0,,2,8,10,1,0,3,0,4,2
1980,Joe Bryant,PF,25,SDC,81,,2328,294,682,.431,5,34,.147,289,648,.446,.435,161,217,.742,171,345,516,144,102,39,170,258,754
1980,Quinn Buckner,PG,25,MIL,67,,1690,306,655,.467,2,5,.400,304,650,.468,.469,105,143,.734,69,169,238,383,135,4,149,202,719
1980,Tom Burleson,C,27,KCK,37,,272,36,104,.346,0,3,.000,36,101,.356,.346,23,40,.575,23,49,72,20,8,13,25,49,95
1980,Don Buse,PG,29,PHO,81,,2499,261,589,.443,19,79,.241,242,510,.475,.459,85,128,.664,70,163,233,320,132,10,91,111,626
1980,Marty Byrnes,SF,23,LAL,32,,194,25,50,.500,0,0,,25,50,.500,.500,13,15,.867,9,18,27,13,5,1,22,32,63
1980,Corky Calhoun,SF,29,IND,7,,30,4,9,.444,0,0,,4,9,.444,.444,0,2,.000,7,3,10,0,2,0,1,6,8
1980,Mack Calvin,PG,32,UTA,48,,772,100,227,.441,1,11,.091,99,216,.458,.443,105,117,.897,13,71,84,134,27,0,57,72,306
1980,Austin Carr,SG,31,CLE,77,,1595,390,839,.465,2,6,.333,388,833,.466,.466,127,172,.738,81,84,165,150,39,3,108,120,909
1980,Kenny Carr,PF,24,TOT,79,,1838,378,768,.492,0,4,.000,378,764,.495,.492,173,263,.658,199,389,588,77,66,52,154,246,929
1980,Kenny Carr,PF,24,LAL,5,,57,7,16,.438,0,0,,7,16,.438,.438,2,2,1.000,5,12,17,1,2,1,9,6,16
1980,Kenny Carr,PF,24,CLE,74,,1781,371,752,.493,0,4,.000,371,748,.496,.493,171,261,.655,194,377,571,76,64,51,145,240,913
1980,M.L. Carr,SF,29,BOS,82,7,1994,362,763,.474,12,41,.293,350,722,.485,.482,178,241,.739,106,224,330,156,120,36,143,214,914
1980,Bob Carrington,SG,26,SDC,10,,134,15,37,.405,0,2,.000,15,35,.429,.405,6,8,.750,6,7,13,3,4,1,5,18,36
1980,Ron Carter,SG,23,IND,13,,117,15,37,.405,0,0,,15,37,.405,.405,2,7,.286,5,14,19,9,2,3,10,19,32
1980,Bill Cartwright,C,22,NYK,82,,3150,665,1215,.547,0,0,,665,1215,.547,.547,451,566,.797,194,532,726,165,48,101,222,279,1781
1980,Harvey Catchings,C,28,MIL,72,,1366,97,244,.398,0,1,.000,97,243,.399,.398,39,62,.629,164,246,410,82,23,162,68,191,233
1980,Don Chaney,SG,33,BOS,60,0,523,67,189,.354,1,6,.167,66,183,.361,.357,32,42,.762,31,42,73,38,31,11,33,80,167
1980,Maurice Cheeks*,PG,23,PHI,79,79,2623,357,661,.540,4,9,.444,353,652,.541,.543,180,231,.779,75,199,274,556,183,32,216,197,898
1980,Phil Chenier,SG,29,TOT,43,,850,136,349,.390,5,12,.417,131,337,.389,.397,49,67,.731,19,59,78,89,33,15,55,55,326
1980,Phil Chenier,SG,29,WSB,20,,470,84,214,.393,3,6,.500,81,208,.389,.400,31,41,.756,10,33,43,42,18,5,29,26,202
1980,Phil Chenier,SG,29,IND,23,,380,52,135,.385,2,6,.333,50,129,.388,.393,18,26,.692,9,26,35,47,15,10,26,29,124
1980,Jim Chones,C,30,LAL,82,,2394,372,760,.489,0,2,.000,372,758,.491,.489,125,169,.740,143,421,564,151,56,65,175,271,869
1980,Jim Cleamons,PG,30,TOT,79,,1789,214,450,.476,7,31,.226,207,419,.494,.483,84,113,.743,53,99,152,288,57,11,109,133,519
1980,Jim Cleamons,PG,30,NYK,22,,254,30,69,.435,3,8,.375,27,61,.443,.457,12,15,.800,10,9,19,40,13,2,17,13,75
1980,Jim Cleamons,PG,30,WSB,57,,1535,184,381,.483,4,23,.174,180,358,.503,.488,72,98,.735,43,90,133,248,44,9,92,120,444
1980,Doug Collins,SG,28,PHI,36,17,963,191,410,.466,0,1,.000,191,409,.467,.466,113,124,.911,29,65,94,100,30,7,82,76,495
1980,Jeff Cook,PF,23,PHO,66,,904,129,275,.469,0,3,.000,129,272,.474,.469,104,129,.806,90,151,241,84,28,18,71,102,362
1980,Michael Cooper,SG,23,LAL,82,,1973,303,578,.524,5,20,.250,298,558,.534,.529,111,143,.776,101,128,229,221,86,38,142,215,722
1980,Wayne Cooper,PF,23,GSW,79,,1781,367,750,.489,1,4,.250,366,746,.491,.490,136,181,.751,202,305,507,42,20,79,140,246,871
1980,Hollis Copeland,SF,24,NYK,75,,1142,182,368,.495,0,2,.000,182,366,.497,.495,63,86,.733,70,86,156,80,61,25,84,154,427
1980,Dave Corzine,C,23,WSB,78,,826,90,216,.417,0,0,,90,216,.417,.417,45,68,.662,104,166,270,63,9,31,60,120,225
1980,John Coughran,SF,28,GSW,24,,160,29,81,.358,2,9,.222,27,72,.375,.370,8,14,.571,2,17,19,12,7,1,13,24,68
1980,Dave Cowens*,C,31,BOS,66,55,2159,422,932,.453,1,12,.083,421,920,.458,.453,95,122,.779,126,408,534,206,69,61,108,216,940
1980,Charlie Criss,PG,31,ATL,81,,1794,249,578,.431,1,17,.059,248,561,.442,.432,172,212,.811,27,89,116,246,74,4,130,133,671
1980,Terry Crosby,PG,23,KCK,4,,28,2,4,.500,0,0,,2,4,.500,.500,2,2,1.000,0,1,1,7,0,0,5,4,6
1980,Pat Cummings,C,23,MIL,71,,900,187,370,.505,0,0,,187,370,.505,.505,94,123,.764,81,157,238,53,22,17,74,141,468
1980,Bob Dandridge*,SF,32,WSB,45,,1457,329,729,.451,2,11,.182,327,718,.455,.453,123,152,.809,63,183,246,178,29,36,123,112,783
1980,Adrian Dantley*,SF,24,UTA,68,,2674,730,1267,.576,0,2,.000,730,1265,.577,.576,443,526,.842,183,333,516,191,96,14,233,211,1903
1980,Brad Davis,PG,24,TOT,18,,268,35,63,.556,0,1,.000,35,62,.565,.556,13,16,.813,4,13,17,50,13,1,14,28,83
1980,Brad Davis,PG,24,IND,5,,43,2,7,.286,0,0,,2,7,.286,.286,3,4,.750,0,2,2,5,3,0,3,7,7
1980,Brad Davis,PG,24,UTA,13,,225,33,56,.589,0,1,.000,33,55,.600,.589,10,12,.833,4,11,15,45,10,1,11,21,76
1980,Harry Davis,SF,24,SAS,4,,30,6,12,.500,0,0,,6,12,.500,.500,1,2,.500,2,4,6,0,1,0,3,8,13
1980,Johnny Davis,PG,24,IND,82,,2912,496,1159,.428,4,42,.095,492,1117,.440,.430,304,352,.864,102,124,226,440,110,23,202,178,1300
1980,Walter Davis,SF,25,PHO,75,,2309,657,1166,.563,0,4,.000,657,1162,.565,.563,299,365,.819,75,197,272,337,114,19,242,202,1613
1980,Darryl Dawkins,C,23,PHI,80,80,2541,494,946,.522,0,6,.000,494,940,.526,.522,190,291,.653,197,496,693,149,49,142,230,328,1178
1980,Paul Dawkins,SF,22,UTA,57,,776,141,300,.470,1,5,.200,140,295,.475,.472,33,48,.688,42,83,125,77,33,9,76,112,316
1980,Greg Deane,SG,22,UTA,7,,48,2,11,.182,1,1,1.000,1,10,.100,.227,5,7,.714,2,4,6,6,0,0,3,3,10
1980,Larry Demic,PF,22,NYK,82,,1872,230,528,.436,0,0,,230,528,.436,.436,110,183,.601,195,288,483,64,56,30,168,306,570
1980,Coby Dietrick,C,31,CHI,79,,1830,227,500,.454,1,9,.111,226,491,.460,.455,90,118,.763,101,262,363,216,89,51,112,230,545
1980,Leon Douglas,C,25,DET,70,,1782,221,455,.486,0,1,.000,221,454,.487,.486,125,185,.676,171,330,501,121,30,62,127,249,567
1980,John Drew,SF,25,ATL,80,,2306,535,1182,.453,0,7,.000,535,1175,.455,.453,489,646,.757,203,268,471,101,91,23,240,313,1559
1980,Terry Duerod,SG,23,DET,67,,1331,282,598,.472,15,53,.283,267,545,.490,.484,45,66,.682,29,69,98,117,41,11,79,102,624
1980,Mike Dunleavy,PG,25,HOU,51,,1036,148,319,.464,3,20,.150,145,299,.485,.469,111,134,.828,26,74,100,210,40,4,110,120,410
1980,T.R. Dunn,SG,24,POR,82,,1841,240,551,.436,0,3,.000,240,548,.438,.436,84,111,.757,132,192,324,147,102,31,91,145,564
1980,James Edwards,C,24,IND,82,,2314,528,1032,.512,0,1,.000,528,1031,.512,.512,231,339,.681,179,399,578,127,55,104,131,324,1287
1980,Bob Elliott,PF,24,NJN,54,,722,101,228,.443,1,4,.250,100,224,.446,.445,104,152,.684,67,118,185,53,29,14,88,97,307
1980,Bo Ellis,PF,25,DEN,48,,502,61,136,.449,0,3,.000,61,133,.459,.449,40,53,.755,51,65,116,30,10,24,24,67,162
1980,Len Elmore,C,27,KCK,58,,915,104,242,.430,0,0,,104,242,.430,.430,51,74,.689,74,183,257,64,41,39,67,154,259
1980,Alex English*,SF,26,TOT,78,,2401,553,1113,.497,2,6,.333,551,1107,.498,.498,210,266,.789,269,336,605,224,73,62,214,206,1318
1980,Alex English*,SF,26,IND,54,,1526,346,686,.504,0,3,.000,346,683,.507,.504,114,140,.814,167,213,380,142,45,33,124,128,806
1980,Alex English*,SF,26,DEN,24,,875,207,427,.485,2,3,.667,205,424,.483,.487,96,126,.762,102,123,225,82,28,29,90,78,512
1980,Julius Erving*,SF,29,PHI,78,78,2812,838,1614,.519,4,20,.200,834,1594,.523,.520,420,534,.787,215,361,576,355,170,140,284,208,2100
1980,Earl Evans,PF,24,DET,36,,381,63,140,.450,7,18,.389,56,122,.459,.475,24,42,.571,26,49,75,37,14,1,36,64,157
1980,Mike Evans,SG,24,SAS,79,,1246,208,464,.448,12,42,.286,196,422,.464,.461,58,85,.682,29,78,107,230,60,9,128,194,486
1980,Eric Fernsten,PF,26,BOS,56,0,431,71,153,.464,0,0,,71,153,.464,.464,33,52,.635,40,56,96,28,17,12,20,43,175
1980,Chris Ford,SG,31,BOS,73,73,2115,330,709,.465,70,164,.427,260,545,.477,.515,86,114,.754,77,104,181,215,111,27,105,178,816
1980,Don Ford,SF,27,TOT,73,,999,131,274,.478,1,3,.333,130,271,.480,.480,45,53,.849,44,141,185,65,22,21,51,131,308
1980,Don Ford,SF,27,LAL,52,,580,66,130,.508,0,1,.000,66,129,.512,.508,23,28,.821,23,75,98,36,11,15,30,86,155
1980,Don Ford,SF,27,CLE,21,,419,65,144,.451,1,2,.500,64,142,.451,.455,22,25,.880,21,66,87,29,11,6,21,45,153
1980,Phil Ford,PG,23,KCK,82,,2621,489,1058,.462,4,23,.174,485,1035,.469,.464,346,423,.818,29,143,172,610,136,4,282,208,1328
1980,Walt Frazier*,PG,34,CLE,3,,27,4,11,.364,0,1,.000,4,10,.400,.364,2,2,1.000,1,2,3,8,2,1,4,2,10
1980,World B. Free,SG,26,SDC,68,,2585,737,1556,.474,9,25,.360,728,1531,.476,.477,572,760,.753,129,109,238,283,81,32,228,195,2055
1980,Terry Furlow,SG,25,TOT,76,,2122,430,926,.464,24,82,.293,406,844,.481,.477,171,196,.872,70,124,194,293,73,23,163,98,1055
1980,Terry Furlow,SG,25,ATL,21,,404,66,161,.410,1,9,.111,65,152,.428,.413,44,51,.863,23,19,42,72,19,9,34,19,177
1980,Terry Furlow,SG,25,UTA,55,,1718,364,765,.476,23,73,.315,341,692,.493,.491,127,145,.876,47,105,152,221,54,14,129,79,878
1980,Mike Gale,PG,29,SAS,67,,1474,171,377,.454,2,13,.154,169,364,.464,.456,97,120,.808,34,118,152,312,123,13,115,134,441
1980,Gary Garland,PG,22,DEN,78,,1106,155,356,.435,6,19,.316,149,337,.442,.444,18,26,.692,50,88,138,145,54,4,73,80,334
1980,Gus Gerard,SF,26,KCK,73,,869,159,348,.457,1,3,.333,158,345,.458,.458,66,100,.660,77,100,177,43,41,26,49,96,385
1980,George Gervin*,SG,27,SAS,78,,2934,1024,1940,.528,32,102,.314,992,1838,.540,.536,505,593,.852,154,249,403,202,110,79,254,208,2585
1980,John Gianelli,C,29,UTA,17,,285,23,66,.348,0,0,,23,66,.348,.348,9,16,.563,14,48,62,17,6,7,22,26,55
1980,Artis Gilmore*,C,30,CHI,48,,1568,305,513,.595,0,0,,305,513,.595,.595,245,344,.712,108,324,432,133,29,59,133,167,855
1980,Jack Givens,SF,23,ATL,82,,1254,182,473,.385,0,2,.000,182,471,.386,.385,106,128,.828,114,128,242,59,51,19,59,132,470
1980,Mike Glenn,SG,24,NYK,75,,800,188,364,.516,2,10,.200,186,354,.525,.519,63,73,.863,21,45,66,85,35,7,38,79,441
1980,Glen Gondrezick,SF,24,DEN,59,,1020,148,286,.517,2,6,.333,146,280,.521,.521,92,121,.760,107,152,259,81,68,16,58,119,390
1980,Mike Green,C,28,KCK,21,,459,69,159,.434,0,2,.000,69,157,.439,.434,24,42,.571,35,78,113,28,13,21,36,55,162
1980,Dave Greenwood,PF,22,CHI,82,,2791,498,1051,.474,1,7,.143,497,1044,.476,.474,337,416,.810,223,550,773,182,60,129,210,313,1334
1980,Kevin Grevey,SF,26,WSB,65,,1818,331,804,.412,34,92,.370,297,712,.417,.433,216,249,.867,80,107,187,177,56,16,102,158,912
1980,Paul Griffin,C,26,SAS,82,,1812,173,313,.553,0,0,,173,313,.553,.553,174,240,.725,154,284,438,250,81,53,131,306,520
1980,Bob Gross,SF,26,POR,62,,1581,221,472,.468,1,10,.100,220,462,.476,.469,95,114,.833,84,165,249,228,60,47,166,179,538
1980,Ernie Grunfeld,SF,24,KCK,80,,1397,186,420,.443,1,2,.500,185,418,.443,.444,101,131,.771,87,145,232,109,56,9,81,151,474
1980,Roy Hamilton,PG,22,DET,72,,1116,115,287,.401,0,2,.000,115,285,.404,.401,103,150,.687,45,62,107,192,48,5,118,82,333
1980,James Hardy,PF,23,UTA,76,,1600,184,363,.507,1,2,.500,183,361,.507,.508,51,66,.773,124,275,399,104,47,87,105,207,420
1980,Joe Hassett,SG,24,IND,74,,1135,215,509,.422,69,198,.348,146,311,.469,.490,24,29,.828,35,59,94,104,46,8,45,85,523
1980,Steve Hawes,PF,29,ATL,82,,1853,304,605,.502,3,8,.375,301,597,.504,.505,150,182,.824,148,348,496,144,74,29,121,205,761
1980,Elvin Hayes*,PF,34,WSB,81,,3183,761,1677,.454,3,13,.231,758,1664,.456,.455,334,478,.699,269,627,896,129,62,189,215,309,1859
1980,Spencer Haywood*,PF,30,LAL,76,,1544,288,591,.487,1,4,.250,287,587,.489,.488,159,206,.772,132,214,346,93,35,57,134,197,736
1980,Gar Heard,PF,31,PHO,82,,1403,171,410,.417,0,2,.000,171,408,.419,.417,64,86,.744,118,262,380,97,84,49,88,177,406
1980,Gerald Henderson,PG,24,BOS,76,2,1061,191,382,.500,2,6,.333,189,376,.503,.503,89,129,.690,37,46,83,147,45,15,109,96,473
1980,Tom Henderson,PG,28,HOU,66,,1551,154,323,.477,0,2,.000,154,321,.480,.477,56,77,.727,34,77,111,274,55,4,102,107,364
1980,Johnny High,PG,22,PHO,82,,1121,144,323,.446,1,7,.143,143,316,.453,.447,120,178,.674,69,104,173,119,71,15,123,172,409
1980,Armond Hill,PG,26,ATL,79,,2092,177,431,.411,1,4,.250,176,427,.412,.412,124,146,.849,31,107,138,424,107,8,171,261,479
1980,Darnell Hillman,PF,30,GSW,49,,708,82,179,.458,0,0,,82,179,.458,.458,34,68,.500,59,121,180,47,21,24,59,128,198
1980,Brad Holland,SG,23,LAL,38,,197,44,104,.423,3,15,.200,41,89,.461,.438,15,16,.938,4,13,17,22,15,1,13,24,106
1980,Lionel Hollins,SG-PG,26,TOT,47,26,1209,212,526,.403,3,20,.150,209,506,.413,.406,101,140,.721,29,60,89,162,76,10,128,103,528
1980,Lionel Hollins,PG,26,POR,20,,413,82,213,.385,1,10,.100,81,203,.399,.387,34,53,.642,5,15,20,50,30,1,60,35,199
1980,Lionel Hollins,SG,26,PHI,27,26,796,130,313,.415,2,10,.200,128,303,.422,.419,67,87,.770,24,45,69,112,46,9,68,68,329
1980,Phil Hubbard,PF,23,DET,64,,1189,210,451,.466,0,2,.000,210,449,.468,.466,165,220,.750,114,206,320,70,48,10,120,202,585
1980,Kim Hughes,C,27,DEN,70,,1208,102,202,.505,0,0,,102,202,.505,.505,15,41,.366,125,201,326,74,66,77,50,184,219
1980,Geoff Huston,PG,22,NYK,71,,923,94,241,.390,3,17,.176,91,224,.406,.396,28,38,.737,14,44,58,159,39,5,73,83,219
1980,Dan Issel*,C,31,DEN,82,,2938,715,1416,.505,4,12,.333,711,1404,.506,.506,517,667,.775,236,483,719,198,88,54,163,190,1951
1980,Phil Jackson*,PF,34,NJN,16,,194,29,46,.630,0,2,.000,29,44,.659,.630,7,10,.700,12,12,24,12,5,4,9,35,65
1980,Abdul Jeelani,SF,25,POR,77,,1286,288,565,.510,0,6,.000,288,559,.515,.510,161,204,.789,114,156,270,95,40,40,117,155,737
1980,Cheese Johnson,SF,22,GSW,9,,53,12,30,.400,0,0,,12,30,.400,.400,3,5,.600,6,8,14,2,1,0,4,11,27
1980,Clemon Johnson,C,23,IND,79,,1541,199,396,.503,0,0,,199,396,.503,.503,74,117,.632,145,249,394,115,48,121,78,211,472
1980,Dennis Johnson*,SG,25,SEA,81,,2937,574,1361,.422,12,58,.207,562,1303,.431,.426,380,487,.780,173,241,414,332,144,82,227,267,1540
1980,Eddie Johnson,SG,24,ATL,79,,2622,590,1212,.487,5,13,.385,585,1199,.488,.489,280,338,.828,95,105,200,370,120,24,189,216,1465
1980,George Johnson,C,31,NJN,81,,2119,248,543,.457,0,1,.000,248,542,.458,.457,89,126,.706,192,410,602,173,53,258,199,312,585
1980,George Johnson,PF,23,DEN,75,,1938,309,649,.476,2,9,.222,307,640,.480,.478,148,189,.783,190,394,584,157,84,67,148,260,768
1980,John Johnson,SF,32,SEA,81,,2533,377,772,.488,0,0,,377,772,.488,.488,161,201,.801,163,263,426,424,76,35,247,213,915
1980,Magic Johnson*,SG,20,LAL,77,,2795,503,949,.530,7,31,.226,496,918,.540,.534,374,462,.810,166,430,596,563,187,41,305,218,1387
1980,Marques Johnson,SF,23,MIL,77,,2686,689,1267,.544,2,9,.222,687,1258,.546,.545,291,368,.791,217,349,566,273,100,70,185,173,1671
1980,Mickey Johnson,PF,27,IND,82,,2647,588,1271,.463,5,32,.156,583,1239,.471,.465,385,482,.799,258,423,681,344,153,112,286,291,1566
1980,Ollie Johnson,SF,30,CHI,79,,1535,262,527,.497,1,11,.091,261,516,.506,.498,82,93,.882,50,113,163,161,59,24,96,165,607
1980,Vinnie Johnson,SG,23,SEA,38,,325,45,115,.391,0,1,.000,45,114,.395,.391,31,39,.795,19,36,55,54,19,4,42,40,121
1980,Bobby Jones*,PF,28,PHI,81,3,2125,398,748,.532,0,3,.000,398,745,.534,.532,257,329,.781,152,298,450,146,102,118,146,223,1053
1980,Caldwell Jones,C,29,PHI,80,80,2771,232,532,.436,0,2,.000,232,530,.438,.436,124,178,.697,219,731,950,164,43,162,218,298,588
1980,Dwight Jones,PF,27,TOT,74,,1448,257,506,.508,0,0,,257,506,.508,.508,146,201,.726,114,254,368,101,28,42,122,207,660
1980,Dwight Jones,PF,27,HOU,21,,278,50,119,.420,0,0,,50,119,.420,.420,27,36,.750,31,41,72,11,4,5,20,48,127
1980,Dwight Jones,PF,27,CHI,53,,1170,207,387,.535,0,0,,207,387,.535,.535,119,165,.721,83,213,296,90,24,37,102,159,533
1980,Major Jones,PF,26,HOU,82,,1545,188,392,.480,1,3,.333,187,389,.481,.481,61,108,.565,147,234,381,67,50,67,112,186,438
1980,Eddie Jordan,PG,25,NJN,82,,2657,437,1017,.430,12,48,.250,425,969,.439,.436,201,258,.779,62,208,270,557,223,27,258,238,1087
1980,Jeff Judkins,SF,23,BOS,65,0,674,139,276,.504,11,27,.407,128,249,.514,.524,62,76,.816,32,34,66,47,29,5,49,91,351
1980,Rich Kelley,C,26,TOT,80,,1839,229,484,.473,0,3,.000,229,481,.476,.473,244,310,.787,200,315,515,178,78,96,198,273,702
1980,Rich Kelley,C,26,NJN,57,,1466,186,399,.466,0,3,.000,186,396,.470,.466,197,250,.788,156,241,397,128,50,79,152,215,569
1980,Rich Kelley,C,26,PHO,23,,373,43,85,.506,0,0,,43,85,.506,.506,47,60,.783,44,74,118,50,28,17,46,58,133
1980,Greg Kelser,SF,22,DET,50,,1233,280,593,.472,3,15,.200,277,578,.479,.475,146,203,.719,124,152,276,108,60,34,140,176,709
1980,Larry Kenon,PF,27,SAS,78,,2798,647,1333,.485,1,9,.111,646,1324,.488,.486,270,345,.783,258,517,775,231,111,18,232,192,1565
1980,Irv Kiffin,SF,28,SAS,26,,212,32,96,.333,0,0,,32,96,.333,.333,18,25,.720,12,28,40,19,10,2,30,43,82
1980,Carl Kilpatrick,C,23,UTA,2,,6,1,2,.500,0,0,,1,2,.500,.500,1,2,.500,1,3,4,0,0,0,0,1,3
1980,Bernard King*,SF,23,UTA,19,,419,71,137,.518,0,0,,71,137,.518,.518,34,63,.540,24,64,88,52,7,4,50,66,176
1980,Reggie King,PF,22,KCK,82,,2052,257,499,.515,0,1,.000,257,498,.516,.515,159,219,.726,184,382,566,106,69,31,100,230,673
1980,Billy Knight,SF,27,IND,75,,1910,385,722,.533,4,15,.267,381,707,.539,.536,212,262,.809,136,225,361,155,82,9,132,96,986
1980,Toby Knight,SF,24,NYK,81,,2945,669,1265,.529,0,2,.000,669,1263,.530,.529,211,261,.808,201,292,493,150,117,86,163,302,1549
1980,Arvid Kramer,C,23,DEN,8,,45,7,22,.318,0,0,,7,22,.318,.318,2,2,1.000,6,6,12,3,0,5,5,8,16
1980,Joel Kramer,C,24,PHO,54,,711,67,143,.469,0,1,.000,67,142,.472,.469,56,70,.800,49,102,151,75,26,5,51,104,190
1980,John Kuester,PG,24,IND,24,,100,12,34,.353,0,1,.000,12,33,.364,.353,5,7,.714,3,11,14,16,7,1,5,8,29
1980,Kevin Kunnert,C,28,POR,18,,302,50,114,.439,0,0,,50,114,.439,.439,26,43,.605,37,75,112,29,7,22,41,59,126
1980,Mitch Kupchak,PF,25,WSB,40,,451,67,160,.419,0,2,.000,67,158,.424,.419,52,75,.693,32,73,105,16,8,8,40,49,186
1980,Sam Lacey,C,31,KCK,81,,2412,303,677,.448,0,1,.000,303,676,.448,.448,137,185,.741,172,473,645,460,111,109,211,307,743
1980,Tom LaGarde,C,24,SEA,82,,1164,146,306,.477,0,0,,146,306,.477,.477,90,137,.657,127,185,312,91,19,34,97,206,382
1980,John Lambert,PF,27,CLE,74,,1324,165,400,.413,0,3,.000,165,397,.416,.413,73,101,.723,138,214,352,56,47,42,64,203,403
1980,Mark Landsberger,C,24,TOT,77,,1510,249,483,.516,0,0,,249,483,.516,.516,116,222,.523,226,387,613,46,33,22,100,140,614
1980,Mark Landsberger,C,24,CHI,54,,1136,183,346,.529,0,0,,183,346,.529,.529,87,166,.524,157,293,450,32,23,17,75,113,453
1980,Mark Landsberger,C,24,LAL,23,,374,66,137,.482,0,0,,66,137,.482,.482,29,56,.518,69,94,163,14,10,5,25,27,161
1980,Bob Lanier*,C,31,TOT,63,,2131,466,867,.537,1,6,.167,465,861,.540,.538,277,354,.782,152,400,552,184,74,89,162,200,1210
1980,Bob Lanier*,C,31,DET,37,,1392,319,584,.546,0,5,.000,319,579,.551,.546,164,210,.781,108,265,373,122,38,60,113,130,802
1980,Bob Lanier*,C,31,MIL,26,,739,147,283,.519,1,1,1.000,146,282,.518,.521,113,144,.785,44,135,179,62,36,29,49,70,408
1980,Allen Leavell,PG,22,HOU,77,,2123,330,656,.503,3,19,.158,327,637,.513,.505,180,221,.814,57,127,184,417,127,28,205,197,843
1980,Butch Lee,PG,23,TOT,14,,55,6,24,.250,0,0,,6,24,.250,.250,6,8,.750,7,4,11,12,1,0,10,2,18
1980,Butch Lee,PG,23,CLE,3,,24,2,11,.182,0,0,,2,11,.182,.182,0,1,.000,3,0,3,3,0,0,3,0,4
1980,Butch Lee,PG,23,LAL,11,,31,4,13,.308,0,0,,4,13,.308,.308,6,7,.857,4,4,8,9,1,0,7,2,14
1980,Ron Lee,PG,27,TOT,61,,1167,113,305,.370,22,59,.373,91,246,.370,.407,44,70,.629,40,83,123,241,99,17,101,172,292
1980,Ron Lee,PG,27,ATL,30,,364,29,91,.319,0,3,.000,29,88,.330,.319,9,17,.529,11,22,33,67,15,4,33,65,67
1980,Ron Lee,PG,27,DET,31,,803,84,214,.393,22,56,.393,62,158,.392,.444,35,53,.660,29,61,90,174,84,13,68,107,225
1980,John Long,SG,23,DET,69,,2364,588,1164,.505,1,12,.083,587,1152,.510,.506,160,194,.825,152,185,337,206,129,26,206,221,1337
1980,John Lucas,PG,26,GSW,80,,2763,388,830,.467,12,42,.286,376,788,.477,.475,222,289,.768,61,159,220,602,138,3,184,196,1010
1980,Maurice Lucas,PF,27,TOT,63,,1884,371,813,.456,2,9,.222,369,804,.459,.458,179,239,.749,143,394,537,208,42,62,218,223,923
1980,Maurice Lucas,PF,27,POR,41,,1176,243,552,.440,2,5,.400,241,547,.441,.442,100,137,.730,85,240,325,125,23,35,148,141,588
1980,Maurice Lucas,PF,27,NJN,22,,708,128,261,.490,0,4,.000,128,257,.498,.490,79,102,.775,58,154,212,83,19,27,70,82,335
1980,Ollie Mack,SG,22,TOT,50,,681,98,199,.492,0,5,.000,98,194,.505,.492,38,51,.745,32,39,71,53,24,3,35,50,234
1980,Ollie Mack,SG,22,LAL,27,,155,21,50,.420,0,1,.000,21,49,.429,.420,9,18,.500,7,15,22,20,4,0,9,16,51
1980,Ollie Mack,SG,22,CHI,23,,526,77,149,.517,0,4,.000,77,145,.531,.517,29,33,.879,25,24,49,33,20,3,26,34,183
1980,Moses Malone*,C,24,HOU,82,,3140,778,1549,.502,0,6,.000,778,1543,.504,.502,563,783,.719,573,617,1190,147,80,107,300,210,2119
1980,Steve Malovic,PF,23,TOT,39,,445,31,67,.463,0,0,,31,67,.463,.463,18,27,.667,36,50,86,26,8,6,23,51,80
1980,Steve Malovic,PF,23,WSB,1,,6,0,0,,0,0,,0,0,,,1,4,.250,0,0,0,0,1,0,0,0,1
1980,Steve Malovic,PF,23,SDC,28,,277,23,42,.548,0,0,,23,42,.548,.548,7,9,.778,27,31,58,12,5,1,14,35,53
1980,Steve Malovic,PF,23,DET,10,,162,8,25,.320,0,0,,8,25,.320,.320,10,14,.714,9,19,28,14,2,5,9,16,26
1980,Pete Maravich*,SG,32,TOT,43,4,964,244,543,.449,10,15,.667,234,528,.443,.459,91,105,.867,17,61,78,83,24,6,82,79,589
1980,Pete Maravich*,SG,32,UTA,17,,522,121,294,.412,7,11,.636,114,283,.403,.423,41,50,.820,7,33,40,54,15,4,45,30,290
1980,Pete Maravich*,SG,32,BOS,26,4,442,123,249,.494,3,4,.750,120,245,.490,.500,50,55,.909,10,28,38,29,9,2,37,49,299
1980,Cedric Maxwell,SF,24,BOS,80,80,2744,457,750,.609,0,0,,457,750,.609,.609,436,554,.787,284,420,704,199,76,61,230,266,1350
1980,Scott May,SF,25,CHI,54,,1298,264,587,.450,0,4,.000,264,583,.453,.450,144,172,.837,78,140,218,104,45,5,77,126,672
1980,Bob McAdoo*,PF,28,DET,58,,2097,492,1025,.480,3,24,.125,489,1001,.489,.481,235,322,.730,100,367,467,200,73,65,238,178,1222
1980,Jim McElroy,PG,26,TOT,67,,1528,228,527,.433,5,21,.238,223,506,.441,.437,132,172,.767,32,67,99,227,46,19,131,123,593
1980,Jim McElroy,PG,26,DET,36,,1012,162,356,.455,3,14,.214,159,342,.465,.459,95,119,.798,12,38,50,162,25,14,88,78,422
1980,Jim McElroy,PG,26,ATL,31,,516,66,171,.386,2,7,.286,64,164,.390,.392,37,53,.698,20,29,49,65,21,5,43,45,171
1980,George McGinnis*,PF,29,TOT,73,,2208,400,886,.451,2,15,.133,398,871,.457,.453,270,488,.553,222,477,699,333,101,23,281,303,1072
1980,George McGinnis*,PF,29,DEN,45,,1424,268,584,.459,1,7,.143,267,577,.463,.460,166,307,.541,134,328,462,221,69,17,188,187,703
1980,George McGinnis*,PF,29,IND,28,,784,132,302,.437,1,8,.125,131,294,.446,.439,104,181,.575,88,149,237,112,32,6,93,116,369
1980,Billy McKinney,PG,24,KCK,76,,1333,206,459,.449,1,10,.100,205,449,.457,.450,107,133,.805,20,66,86,248,58,5,89,87,520
1980,Tom McMillen,C,27,ATL,53,,1071,191,382,.500,0,1,.000,191,381,.501,.500,81,107,.757,70,150,220,62,36,14,64,126,463
1980,John Mengelt,SG,30,CHI,36,,387,90,166,.542,0,6,.000,90,160,.563,.542,39,49,.796,3,20,23,38,10,0,36,54,219
1980,Joe Meriweather,PF,26,NYK,65,,1565,252,477,.528,0,1,.000,252,476,.529,.528,78,121,.645,122,228,350,66,37,120,112,239,582
1980,Dave Meyers,PF,26,MIL,79,,2204,399,830,.481,1,5,.200,398,825,.482,.481,156,246,.634,140,308,448,225,72,40,182,218,955
1980,Mike Mitchell,SF,24,CLE,82,,2802,775,1482,.523,0,6,.000,775,1476,.525,.523,270,343,.787,206,385,591,93,70,77,172,259,1820
1980,Steve Mix,SF,32,PHI,81,5,1543,363,703,.516,4,10,.400,359,693,.518,.519,207,249,.831,114,176,290,149,67,9,132,114,937
1980,Paul Mokeski,C,23,HOU,12,,113,11,33,.333,0,0,,11,33,.333,.333,7,9,.778,14,15,29,2,1,6,10,24,29
1980,Sidney Moncrief*,SG,22,MIL,77,,1557,211,451,.468,0,1,.000,211,450,.469,.468,232,292,.795,154,184,338,133,72,16,117,106,654
1980,Eric Money,SG-PG,24,TOT,61,,1549,273,546,.500,0,0,,273,546,.500,.500,83,106,.783,31,73,104,254,53,11,155,146,629
1980,Eric Money,PG,24,PHI,6,,82,14,36,.389,0,0,,14,36,.389,.389,2,2,1.000,3,4,7,16,0,1,12,11,30
1980,Eric Money,SG,24,DET,55,,1467,259,510,.508,0,0,,259,510,.508,.508,81,104,.779,28,69,97,238,53,10,143,135,599
1980,Earl Monroe*,SG,35,NYK,51,,633,161,352,.457,0,0,,161,352,.457,.457,56,64,.875,16,20,36,67,21,3,28,46,378
1980,Calvin Murphy*,SG,31,HOU,76,,2676,624,1267,.493,1,25,.040,623,1242,.502,.493,271,302,.897,68,82,150,299,143,9,162,269,1520
1980,Swen Nater,C,30,SDC,81,,2860,443,799,.554,0,2,.000,443,797,.556,.554,196,273,.718,352,864,1216,233,45,37,257,259,1082
1980,Calvin Natt,SF,23,TOT,78,,2857,622,1298,.479,3,9,.333,619,1289,.480,.480,306,419,.730,239,452,691,169,102,34,198,205,1553
1980,Calvin Natt,SF,23,NJN,53,,2046,421,879,.479,1,5,.200,420,874,.481,.480,199,280,.711,173,340,513,112,78,22,133,148,1042
1980,Calvin Natt,SF,23,POR,25,,811,201,419,.480,2,4,.500,199,415,.480,.482,107,139,.770,66,112,178,57,24,12,65,57,511
1980,Mike Newlin,SG,31,NJN,78,,2510,611,1329,.460,45,152,.296,566,1177,.481,.477,367,415,.884,101,163,264,314,115,4,231,195,1634
1980,Norm Nixon,PG,24,LAL,82,,3226,624,1209,.516,1,8,.125,623,1201,.519,.517,197,253,.779,52,177,229,642,147,14,288,241,1446
1980,Sylvester Norris,C,22,SAS,17,,189,18,43,.419,0,0,,18,43,.419,.419,4,6,.667,10,33,43,6,3,12,19,41,40
1980,Mark Olberding,SF,23,SAS,75,,2111,291,609,.478,0,3,.000,291,606,.480,.478,210,264,.795,83,335,418,327,67,22,180,274,792
1980,John Olive,SF,24,SDC,1,,15,0,2,.000,0,0,,0,2,.000,.000,0,0,,0,1,1,0,0,0,2,2,0
1980,Tom Owens,C,30,POR,76,,2337,518,1008,.514,1,2,.500,517,1006,.514,.514,213,283,.753,189,384,573,194,45,53,174,270,1250
1980,Robert Parish*,C,26,GSW,72,,2119,510,1006,.507,0,1,.000,510,1005,.507,.507,203,284,.715,247,536,783,122,58,115,225,248,1223
1980,Sonny Parker,SF,24,GSW,82,,2849,483,988,.489,0,2,.000,483,986,.490,.489,237,302,.785,166,298,464,254,173,32,163,195,1203
1980,Billy Paultz,C,31,TOT,84,,2193,327,673,.486,0,1,.000,327,672,.487,.486,109,182,.599,187,399,586,188,69,84,115,213,763
1980,Billy Paultz,C,31,SAS,47,,1213,189,381,.496,0,1,.000,189,380,.497,.496,66,100,.660,95,226,321,118,47,45,58,127,444
1980,Billy Paultz,C,31,HOU,37,,980,138,292,.473,0,0,,138,292,.473,.473,43,82,.524,92,173,265,70,22,39,57,86,319
1980,Jim Paxson,SG,22,POR,72,,1270,189,460,.411,1,22,.045,188,438,.429,.412,64,90,.711,25,84,109,144,48,5,93,97,443
1980,Wiley Peck,SF,22,SAS,52,,628,73,169,.432,0,2,.000,73,167,.437,.432,34,55,.618,66,117,183,33,17,23,48,100,180
1980,Sam Pellom,PF,28,ATL,44,,373,44,108,.407,0,0,,44,108,.407,.407,21,30,.700,28,64,92,18,12,12,18,70,109
1980,Roger Phegley,SG,23,TOT,78,,1512,350,733,.477,4,9,.444,346,724,.478,.480,177,203,.872,75,110,185,102,34,7,119,158,881
1980,Roger Phegley,SG,23,WSB,50,,971,224,473,.474,2,5,.400,222,468,.474,.476,104,120,.867,49,66,115,70,19,3,70,106,554
1980,Roger Phegley,SG,23,NJN,28,,541,126,260,.485,2,4,.500,124,256,.484,.488,73,83,.880,26,44,70,32,15,4,49,52,327
1980,Stan Pietkiewicz,PG,23,SDC,50,,577,91,179,.508,9,36,.250,82,143,.573,.534,37,46,.804,26,19,45,94,25,4,51,52,228
1980,Ben Poquette,C,24,UTA,82,,2349,296,566,.523,0,2,.000,296,564,.525,.523,139,167,.832,124,436,560,131,45,162,103,283,731
1980,Kevin Porter,PG,29,WSB,70,,1494,201,438,.459,0,4,.000,201,434,.463,.459,110,137,.803,25,57,82,457,59,11,164,180,512
1980,Clifford Ray,C,31,GSW,81,,1683,203,383,.530,0,2,.000,203,381,.533,.530,84,149,.564,122,344,466,183,51,32,155,266,490
1980,Marlon Redmond,SG,24,KCK,24,,298,59,138,.428,0,9,.000,59,129,.457,.428,24,34,.706,18,34,52,19,4,9,19,27,142
1980,Robert Reid,SF,24,HOU,76,,2304,419,861,.487,0,3,.000,419,858,.488,.487,153,208,.736,140,301,441,244,132,57,164,281,991
1980,Kevin Restani,SF,28,SAS,82,,1966,369,727,.508,5,29,.172,364,698,.521,.511,131,161,.814,142,244,386,189,54,12,129,186,874
1980,Clint Richardson,SG,23,PHI,52,34,988,159,348,.457,1,3,.333,158,345,.458,.458,28,45,.622,55,68,123,107,24,15,64,97,347
1980,Micheal Ray Richardson,SG,24,NYK,82,,3060,502,1063,.472,27,110,.245,475,953,.498,.485,223,338,.660,151,388,539,832,265,35,359,260,1254
1980,Anthony Roberts,SF,24,DEN,23,,486,69,181,.381,0,1,.000,69,180,.383,.381,39,60,.650,54,55,109,20,13,3,28,52,177
1980,Rick Robey,C,24,BOS,82,27,1918,379,727,.521,0,1,.000,379,726,.522,.521,184,269,.684,209,321,530,92,53,15,151,244,942
1980,Cliff Robinson,PF,19,NJN,70,,1661,391,833,.469,1,4,.250,390,829,.470,.470,168,242,.694,174,332,506,98,61,34,137,178,951
1980,Jackie Robinson,SF,24,DET,7,,51,9,17,.529,0,1,.000,9,16,.563,.529,9,11,.818,3,2,5,0,3,3,2,8,27
1980,Truck Robinson,PF,28,PHO,82,,2710,545,1064,.512,0,0,,545,1064,.512,.512,325,487,.667,213,557,770,142,58,59,251,262,1415
1980,Bill Robinzine,PF,27,KCK,81,,1917,362,723,.501,1,2,.500,361,721,.501,.501,200,274,.730,184,342,526,62,106,23,148,311,925
1980,Dave Robisch,C,30,CLE,82,,2670,489,940,.520,0,3,.000,489,937,.522,.520,277,329,.842,225,433,658,192,53,53,138,211,1255
1980,John Roche,PG,30,DEN,82,,2286,354,741,.478,49,129,.380,305,612,.498,.511,175,202,.866,24,91,115,405,82,12,159,139,932
1980,Tree Rollins,C,24,ATL,82,,2123,287,514,.558,0,0,,287,514,.558,.558,157,220,.714,283,491,774,76,54,244,99,322,731
1980,Dan Roundfield,PF,26,ATL,81,,2588,502,1007,.499,0,4,.000,502,1003,.500,.499,330,465,.710,293,544,837,184,101,139,233,317,1334
1980,Campy Russell,SF,28,CLE,41,,1331,284,630,.451,1,9,.111,283,621,.456,.452,178,239,.745,76,149,225,173,72,20,148,113,747
1980,Alvin Scott,SF,24,PHO,79,,1303,127,301,.422,1,3,.333,126,298,.423,.424,95,122,.779,89,139,228,98,47,53,92,101,350
1980,Charlie Scott*,SG,31,DEN,69,,1860,276,688,.401,2,11,.182,274,677,.405,.403,85,118,.720,51,115,166,250,47,23,163,197,639
1980,Lonnie Shelton,PF,24,SEA,76,,2243,425,802,.530,1,5,.200,424,797,.532,.531,184,241,.763,199,383,582,145,92,79,169,292,1035
1980,Purvis Short,SF,22,GSW,62,,1636,461,916,.503,0,6,.000,461,910,.507,.503,134,165,.812,119,197,316,123,63,9,122,186,1056
1980,John Shumate,PF,27,TOT,65,,1337,207,392,.528,0,1,.000,207,391,.529,.528,165,216,.764,108,255,363,84,40,45,91,126,579
1980,John Shumate,PF,27,DET,9,,228,35,65,.538,0,0,,35,65,.538,.538,17,25,.680,18,52,70,9,9,5,14,16,87
1980,John Shumate,PF,27,HOU,29,,332,34,64,.531,0,0,,34,64,.531,.531,33,44,.750,25,54,79,23,8,9,27,39,101
1980,John Shumate,PF,27,SAS,27,,777,138,263,.525,0,1,.000,138,262,.527,.525,115,147,.782,65,149,214,52,23,31,50,71,391
1980,Jack Sikma*,C,24,SEA,82,,2793,470,989,.475,0,1,.000,470,988,.476,.475,235,292,.805,198,710,908,279,68,77,202,232,1175
1980,James Silas,PG,30,SAS,77,,2293,513,999,.514,0,4,.000,513,995,.516,.514,339,382,.887,45,122,167,347,61,14,192,206,1365
1980,Paul Silas,PF,36,SEA,82,,1595,113,299,.378,0,0,,113,299,.378,.378,89,136,.654,204,232,436,66,25,5,83,120,315
1980,Ralph Simpson,SG,30,NJN,8,,81,18,47,.383,0,2,.000,18,45,.400,.383,5,10,.500,6,5,11,14,9,0,12,3,41
1980,Al Skinner,SG,27,PHI,2,,10,1,2,.500,0,0,,1,2,.500,.500,0,0,,0,0,0,2,0,0,2,1,2
1980,Bingo Smith,SF-SG,33,TOT,78,,2123,385,891,.432,23,81,.284,362,810,.447,.445,100,115,.870,94,165,259,100,62,17,81,209,893
1980,Bingo Smith,SG,33,CLE,8,,135,33,72,.458,1,5,.200,32,67,.478,.465,7,8,.875,2,12,14,7,3,2,9,21,74
1980,Bingo Smith,SF,33,SDC,70,,1988,352,819,.430,22,76,.289,330,743,.444,.443,93,107,.869,92,153,245,93,59,15,72,188,819
1980,Phil Smith,SG,27,GSW,51,,1552,325,685,.474,7,22,.318,318,663,.480,.480,135,171,.789,28,118,146,187,62,15,121,154,792
1980,Randy Smith,SG,31,CLE,82,,2677,599,1326,.452,10,53,.189,589,1273,.463,.456,233,283,.823,93,163,256,363,125,7,200,190,1441
1980,Robert Smith,PG,24,TOT,65,,809,118,269,.439,8,26,.308,110,243,.453,.454,80,92,.870,20,59,79,92,26,4,53,105,324
1980,Robert Smith,PG,24,UTA,6,,73,5,15,.333,0,0,,5,15,.333,.333,5,5,1.000,3,0,3,7,4,0,1,3,15
1980,Robert Smith,PG,24,NJN,59,,736,113,254,.445,8,26,.308,105,228,.461,.461,75,87,.862,17,59,76,85,22,4,52,102,309
1980,Sam Smith,SF,25,CHI,30,,496,97,230,.422,8,35,.229,89,195,.456,.439,57,63,.905,22,32,54,42,25,7,33,54,259
1980,Willie Smith,PG,26,CLE,62,,1051,121,315,.384,17,71,.239,104,244,.426,.411,40,52,.769,56,65,121,259,75,1,95,110,299
1980,Ricky Sobers,PG,27,CHI,82,,2673,470,1002,.469,21,68,.309,449,934,.481,.480,200,239,.837,75,167,242,426,136,17,282,294,1161
1980,Jim Spanarkel,SG,22,PHI,40,,442,72,153,.471,0,2,.000,72,151,.477,.471,54,65,.831,27,27,54,51,12,6,57,58,198
1980,Larry Steele,SF,30,POR,16,,446,62,146,.425,0,4,.000,62,142,.437,.425,22,27,.815,13,32,45,67,25,1,33,53,146
1980,Earl Tatum,SG,26,CLE,33,,225,36,94,.383,2,6,.333,34,88,.386,.394,11,19,.579,11,15,26,20,16,5,17,29,85
1980,Brian Taylor,PG,28,SDC,78,,2754,418,895,.467,90,239,.377,328,656,.500,.517,130,162,.802,76,112,188,335,147,25,141,246,1056
1980,Reggie Theus,SG,22,CHI,82,,3029,566,1172,.483,28,105,.267,538,1067,.504,.495,500,597,.838,143,186,329,515,114,20,348,262,1660
1980,David Thompson*,SG,25,DEN,39,,1239,289,617,.468,7,19,.368,282,598,.472,.474,254,335,.758,56,118,174,124,39,38,116,106,839
1980,Rudy Tomjanovich*,PF,31,HOU,62,,1834,370,778,.476,22,79,.278,348,699,.498,.490,118,147,.803,132,226,358,109,32,10,98,161,880
1980,Bernard Toone,PF,23,PHI,23,,124,23,64,.359,1,7,.143,22,57,.386,.367,8,10,.800,12,22,34,12,4,5,16,20,55
1980,Raymond Townsend,SG,24,GSW,75,,1159,171,421,.406,4,26,.154,167,395,.423,.411,60,84,.714,33,56,89,116,60,4,65,113,406
1980,Dave Twardzik,PG,29,POR,67,,1594,183,394,.464,4,7,.571,179,387,.463,.470,197,252,.782,52,104,156,273,77,1,131,149,567
1980,Terry Tyler,SF,23,DET,82,,2670,430,925,.465,2,12,.167,428,913,.469,.466,143,187,.765,228,399,627,129,107,220,175,237,1005
1980,Wes Unseld*,C,33,WSB,82,,2973,327,637,.513,1,2,.500,326,635,.513,.514,139,209,.665,334,760,1094,366,65,61,153,249,794
1980,Jan van Breda Kolff,SF,28,NJN,82,,2399,212,458,.463,7,20,.350,205,438,.468,.471,130,155,.839,103,326,429,247,100,76,158,307,561
1980,Andre Wakefield,SG,25,UTA,8,,47,6,15,.400,0,0,,6,15,.400,.400,3,3,1.000,0,4,4,3,1,0,8,13,15
1980,Foots Walker,PG,28,CLE,76,,2422,258,568,.454,1,9,.111,257,559,.460,.455,195,243,.802,78,209,287,607,155,12,157,202,712
1980,Wally Walker,SF,25,SEA,70,,844,139,274,.507,0,0,,139,274,.507,.507,48,64,.750,64,106,170,53,21,4,50,102,326
1980,Bill Walton*,C,27,SDC,14,,337,81,161,.503,0,0,,81,161,.503,.503,32,54,.593,28,98,126,34,8,38,37,37,194
1980,Lloyd Walton,PG,26,MIL,76,,1243,110,242,.455,1,3,.333,109,239,.456,.457,49,71,.690,33,58,91,285,43,2,112,68,270
1980,Kermit Washington,PF,28,POR,80,,2657,421,761,.553,0,3,.000,421,758,.555,.553,231,360,.642,325,517,842,167,73,131,170,307,1073
1980,Richard Washington,PF,24,MIL,75,,1092,197,421,.468,0,0,,197,421,.468,.468,46,76,.605,95,181,276,55,26,48,63,166,440
1980,Nick Weatherspoon,SF,29,SDC,57,,1124,164,378,.434,0,0,,164,378,.434,.434,63,91,.692,83,125,208,54,34,17,86,136,391
1980,Marvin Webster,C,27,NYK,20,,298,38,79,.481,0,0,,38,79,.481,.481,12,16,.750,28,52,80,9,3,11,20,39,88
1980,Scott Wedman,SF,27,KCK,68,,2347,569,1112,.512,7,22,.318,562,1090,.516,.515,145,181,.801,114,272,386,145,84,45,112,230,1290
1980,Paul Westphal*,SG,29,PHO,82,,2665,692,1317,.525,26,93,.280,666,1224,.544,.535,382,443,.862,46,141,187,416,119,35,207,162,1792
1980,Jo Jo White*,PG,33,GSW,78,,2052,336,706,.476,1,6,.167,335,700,.479,.477,97,114,.851,42,139,181,239,88,13,157,186,770
1980,Rudy White,SG,26,HOU,9,,106,13,24,.542,0,0,,13,24,.542,.542,10,13,.769,0,9,9,5,5,0,8,8,36
1980,Jerome Whitehead,C,23,TOT,50,,553,58,114,.509,0,0,,58,114,.509,.509,10,35,.286,56,111,167,24,8,17,36,97,126
1980,Jerome Whitehead,C,23,SDC,18,,225,27,45,.600,0,0,,27,45,.600,.600,5,18,.278,29,41,70,6,1,6,8,32,59
1980,Jerome Whitehead,C,23,UTA,32,,328,31,69,.449,0,0,,31,69,.449,.449,5,17,.294,27,70,97,18,7,11,28,65,67
1980,Sidney Wicks,PF,30,SDC,71,,2146,210,496,.423,0,1,.000,210,495,.424,.423,83,152,.546,138,271,409,213,76,52,167,241,503
1980,Bob Wilkerson,SF,25,DEN,75,,2381,430,1030,.417,7,34,.206,423,996,.425,.421,166,222,.748,85,231,316,243,93,27,193,194,1033
1980,Jamaal Wilkes*,SF,26,LAL,82,,3111,726,1358,.535,3,17,.176,723,1341,.539,.536,189,234,.808,176,349,525,250,129,28,157,220,1644
1980,Duck Williams,PG,23,UTA,77,,1794,232,519,.447,0,12,.000,232,507,.458,.447,42,60,.700,21,85,106,183,100,11,107,166,506
1980,Freeman Williams,SG,23,SDC,82,,2118,645,1343,.480,42,128,.328,603,1215,.496,.496,194,238,.815,103,89,192,166,72,9,171,145,1526
1980,Gus Williams,PG,26,SEA,82,,2969,739,1533,.482,7,36,.194,732,1497,.489,.484,331,420,.788,127,148,275,397,200,37,181,160,1816
1980,Ray Williams,PG,25,NYK,82,,2582,687,1384,.496,7,37,.189,680,1347,.505,.499,333,423,.787,149,263,412,512,167,24,256,295,1714
1980,Sly Williams,SF,22,NYK,57,,556,104,267,.390,0,4,.000,104,263,.395,.390,58,90,.644,65,56,121,36,19,8,49,73,266
1980,John Williamson,SG,28,TOT,58,,1374,359,817,.439,11,35,.314,348,782,.445,.446,116,138,.841,38,61,99,126,36,19,92,137,845
1980,John Williamson,SG,28,NJN,28,,771,206,461,.447,8,19,.421,198,442,.448,.456,76,88,.864,24,30,54,87,26,9,43,71,496
1980,John Williamson,SG,28,WSB,30,,603,153,356,.430,3,16,.188,150,340,.441,.434,40,50,.800,14,31,45,39,10,10,49,66,349
1980,Bill Willoughby,SF,22,CLE,78,,1447,219,457,.479,1,9,.111,218,448,.487,.480,96,127,.756,122,207,329,72,32,62,68,189,535
1980,Bubba Wilson,SG,24,GSW,16,,143,7,25,.280,0,0,,7,25,.280,.280,3,6,.500,6,10,16,12,2,0,8,11,17
1980,Rick Wilson,SG,23,ATL,5,,59,2,14,.143,0,0,,2,14,.143,.143,4,6,.667,2,1,3,11,4,1,8,3,8
1980,Brian Winters,SG,27,MIL,80,,2623,535,1116,.479,38,102,.373,497,1014,.490,.496,184,214,.860,48,175,223,362,101,28,186,208,1292
1980,Larry Wright,PG,25,WSB,76,,1286,229,500,.458,4,16,.250,225,484,.465,.462,96,108,.889,40,82,122,222,49,18,108,144,558
1980,Tony Zeno,SF,22,IND,8,,59,6,21,.286,0,0,,6,21,.286,.286,2,2,1.000,3,11,14,1,4,3,9,13,14
1981,Kareem Abdul-Jabbar*,C,33,LAL,80,,2976,836,1457,.574,0,1,.000,836,1456,.574,.574,423,552,.766,197,624,821,272,59,228,249,244,2095
1981,Tom Abernethy,SF,26,TOT,39,,298,25,59,.424,0,1,.000,25,58,.431,.424,13,22,.591,20,28,48,19,7,3,8,34,63
1981,Tom Abernethy,SF,26,GSW,10,,39,1,3,.333,0,0,,1,3,.333,.333,2,3,.667,1,7,8,1,1,0,2,5,4
1981,Tom Abernethy,SF,26,IND,29,,259,24,56,.429,0,1,.000,24,55,.436,.429,11,19,.579,19,21,40,18,6,3,6,29,59
1981,Alvan Adams,C,26,PHO,75,,2054,458,870,.526,0,0,,458,870,.526,.526,199,259,.768,157,389,546,344,106,69,226,226,1115
1981,Darrell Allums,PF,22,DAL,22,,276,23,67,.343,0,1,.000,23,66,.348,.343,13,22,.591,19,46,65,25,5,8,23,51,59
1981,Tiny Archibald*,PG,32,BOS,80,72,2820,382,766,.499,0,9,.000,382,757,.505,.499,342,419,.816,36,140,176,618,75,18,265,201,1106
1981,Dennis Awtrey,C,32,SEA,47,,607,44,93,.473,0,0,,44,93,.473,.473,14,20,.700,33,75,108,54,12,8,33,85,102
1981,James Bailey,PF,23,SEA,82,,2539,444,889,.499,1,2,.500,443,887,.499,.500,256,361,.709,192,415,607,98,74,143,219,332,1145
1981,Greg Ballard,SF,26,WSB,82,,2610,549,1186,.463,7,32,.219,542,1154,.470,.466,166,196,.847,167,413,580,195,118,39,117,194,1271
1981,Mike Bantom,SF,29,IND,76,,2375,431,882,.489,0,6,.000,431,876,.492,.489,199,281,.708,150,277,427,240,80,85,197,284,1061
1981,Billy Ray Bates,SG,24,POR,77,,1560,439,902,.487,14,54,.259,425,848,.501,.494,170,199,.854,71,86,157,196,82,6,149,120,1062
1981,Mel Bennett,PF,26,UTA,28,,313,26,60,.433,0,2,.000,26,58,.448,.433,53,81,.654,33,60,93,15,3,11,31,56,105
1981,Kent Benson,C,26,DET,59,,1956,364,770,.473,0,4,.000,364,766,.475,.473,196,254,.772,124,276,400,172,72,67,190,184,924
1981,Henry Bibby,PG,31,SDC,73,,1112,118,306,.386,32,95,.337,86,211,.408,.438,67,98,.684,25,49,74,200,47,2,76,85,335
1981,Larry Bird*,PF,24,BOS,82,82,3239,719,1503,.478,20,74,.270,699,1429,.489,.485,283,328,.863,191,704,895,451,161,63,289,239,1741
1981,Otis Birdsong,SG,25,KCK,71,,2593,710,1306,.544,10,35,.286,700,1271,.551,.547,317,455,.697,119,139,258,233,93,18,173,172,1747
1981,Norman Black,SG,23,DET,3,,28,3,10,.300,0,0,,3,10,.300,.300,2,8,.250,0,2,2,2,1,0,1,2,8
1981,Ron Boone,SG,34,UTA,52,,1146,160,371,.431,11,39,.282,149,332,.449,.446,75,94,.798,17,67,84,161,33,8,111,126,406
1981,Winford Boynes,SG,23,DAL,44,,757,121,313,.387,0,0,,121,313,.387,.387,45,55,.818,24,51,75,37,23,16,69,79,287
1981,Dudley Bradley,SG,23,IND,82,,1867,265,559,.474,2,16,.125,263,543,.484,.476,125,178,.702,70,123,193,188,186,37,122,236,657
1981,Mike Bratz,PG,25,CLE,80,,2595,319,817,.390,57,169,.337,262,648,.404,.425,107,132,.811,66,132,198,452,136,17,162,194,802
1981,Jim Brewer,PF,29,LAL,78,,1107,101,197,.513,0,2,.000,101,195,.518,.513,15,40,.375,127,154,281,55,43,58,48,158,217
1981,Ron Brewer,SG,25,TOT,75,,1452,275,631,.436,1,7,.143,274,624,.439,.437,91,114,.798,34,52,86,148,61,34,92,95,642
1981,Ron Brewer,SG,25,POR,29,,548,95,246,.386,1,3,.333,94,243,.387,.388,26,34,.765,13,20,33,55,34,9,38,42,217
1981,Ron Brewer,SG,25,SAS,46,,904,180,385,.468,0,4,.000,180,381,.472,.468,65,80,.813,21,32,53,93,27,25,54,53,425
1981,Junior Bridgeman,SF,27,MIL,77,,2215,537,1102,.487,3,21,.143,534,1081,.494,.489,213,241,.884,78,211,289,234,88,28,150,182,1290
1981,Allan Bristow,SF,29,UTA,82,,2001,271,611,.444,5,18,.278,266,593,.449,.448,166,198,.838,103,327,430,383,63,3,171,190,713
1981,Dave Britton,PG,22,WSB,2,,9,2,3,.667,0,0,,2,3,.667,.667,0,0,,0,2,2,3,1,0,2,2,4
1981,Michael Brooks,SF,22,SDC,82,,2479,488,1018,.479,0,6,.000,488,1012,.482,.479,226,320,.706,210,232,442,208,99,31,163,234,1202
1981,Fred Brown,SG,32,SEA,78,,1986,505,1035,.488,23,64,.359,482,971,.496,.499,173,208,.832,53,122,175,233,88,13,131,141,1206
1981,Lewis Brown,C,25,WSB,2,,5,0,3,.000,0,0,,0,3,.000,.000,2,5,.400,1,1,2,0,0,0,1,2,2
1981,Rickey Brown,C,22,GSW,45,,580,83,162,.512,0,0,,83,162,.512,.512,16,21,.762,52,114,166,21,9,14,31,103,182
1981,Joe Bryant,PF,26,SDC,82,,2359,379,791,.479,2,15,.133,377,776,.486,.480,193,244,.791,146,294,440,189,72,34,176,264,953
1981,Quinn Buckner,PG,26,MIL,82,,2384,471,956,.493,1,6,.167,470,950,.495,.493,149,203,.734,88,210,298,384,197,3,236,271,1092
1981,Tom Burleson,C,28,ATL,31,,363,41,99,.414,0,0,,41,99,.414,.414,20,41,.488,44,50,94,12,8,19,24,73,102
1981,Don Buse,SG,30,IND,58,,1095,114,287,.397,19,58,.328,95,229,.415,.430,50,65,.769,19,65,84,140,74,8,38,61,297
1981,Marty Byrnes,SF,24,DAL,72,,1360,216,451,.479,9,20,.450,207,431,.480,.489,120,157,.764,74,103,177,113,29,17,61,126,561
1981,Mack Calvin,PG,33,CLE,21,,128,13,39,.333,1,5,.200,12,34,.353,.346,25,35,.714,2,10,12,28,5,0,17,13,52
1981,Austin Carr,SG,32,TOT,47,,657,87,234,.372,0,7,.000,87,227,.383,.372,34,54,.630,22,39,61,58,15,2,41,53,208
1981,Austin Carr,SG,32,DAL,8,,77,7,28,.250,0,0,,7,28,.250,.250,2,4,.500,4,5,9,9,1,0,9,10,16
1981,Austin Carr,SG,32,WSB,39,,580,80,206,.388,0,7,.000,80,199,.402,.388,32,50,.640,18,34,52,49,14,2,32,43,192
1981,Kenny Carr,PF,25,CLE,81,,2615,469,918,.511,0,4,.000,469,914,.513,.511,292,409,.714,260,575,835,192,76,42,231,296,1230
1981,M.L. Carr,SF,30,BOS,41,7,655,97,216,.449,1,14,.071,96,202,.475,.451,53,67,.791,26,57,83,56,30,18,47,74,248
1981,Joe Barry Carroll,C,22,GSW,82,,2919,616,1254,.491,0,2,.000,616,1252,.492,.491,315,440,.716,274,485,759,117,50,121,243,313,1547
1981,Butch Carter,SF,22,LAL,54,,672,114,247,.462,3,10,.300,111,237,.468,.468,70,95,.737,34,31,65,52,23,1,50,99,301
1981,Reggie Carter,SG,23,NYK,60,,536,59,179,.330,0,3,.000,59,176,.335,.330,51,69,.739,30,39,69,76,22,2,38,68,169
1981,Bill Cartwright,C,23,NYK,82,,2925,619,1118,.554,0,1,.000,619,1117,.554,.554,408,518,.788,161,452,613,111,48,83,200,259,1646
1981,Harvey Catchings,PF,29,MIL,77,,1635,134,300,.447,0,0,,134,300,.447,.447,59,92,.641,154,319,473,99,33,184,105,284,327
1981,Maurice Cheeks*,PG,24,PHI,81,81,2415,310,581,.534,3,8,.375,307,573,.536,.536,140,178,.787,67,178,245,560,193,39,174,231,763
1981,Phil Chenier,SG,30,GSW,9,,82,11,33,.333,1,3,.333,10,30,.333,.348,6,6,1.000,1,7,8,7,0,0,4,10,29
1981,Jim Chones,PF,31,LAL,82,,2562,378,751,.503,0,4,.000,378,747,.506,.503,126,193,.653,180,477,657,153,39,96,159,324,882
1981,Art Collins,SG,26,ATL,29,,395,35,99,.354,0,2,.000,35,97,.361,.354,24,36,.667,19,22,41,25,11,1,32,35,94
1981,Don Collins,SF,22,TOT,81,,1845,360,811,.444,0,6,.000,360,805,.447,.444,211,272,.776,129,139,268,190,104,25,174,259,931
1981,Don Collins,SF,22,ATL,47,,1184,230,530,.434,0,3,.000,230,527,.436,.434,137,162,.846,96,91,187,115,69,11,107,166,597
1981,Don Collins,SF,22,WSB,34,,661,130,281,.463,0,3,.000,130,278,.468,.463,74,110,.673,33,48,81,75,35,14,67,93,334
1981,Doug Collins,SG,29,PHI,12,12,329,62,126,.492,0,0,,62,126,.492,.492,24,29,.828,6,23,29,42,7,4,22,23,148
1981,Darwin Cook,SG,22,NJN,81,,1980,383,819,.468,6,25,.240,377,794,.475,.471,132,180,.733,96,140,236,297,141,36,176,197,904
1981,Jeff Cook,SF,24,PHO,79,,2192,286,616,.464,0,5,.000,286,611,.468,.464,100,155,.645,170,297,467,201,82,54,146,236,672
1981,Michael Cooper,SG,24,LAL,81,,2625,321,654,.491,4,19,.211,317,635,.499,.494,117,149,.785,121,215,336,332,133,78,164,249,763
1981,Wayne Cooper,C,24,UTA,71,,1420,213,471,.452,1,3,.333,212,468,.453,.453,62,90,.689,166,274,440,52,18,51,77,219,489
1981,Dave Corzine,C,24,SAS,82,,1960,366,747,.490,0,3,.000,366,744,.492,.490,125,175,.714,228,408,636,117,42,99,131,212,857
1981,Charlie Criss,PG,32,ATL,66,,1708,220,485,.454,1,21,.048,219,464,.472,.455,185,214,.864,26,74,100,283,61,3,134,87,626
1981,Geoff Crompton,C,25,POR,6,,33,4,8,.500,0,0,,4,8,.500,.500,1,5,.200,7,11,18,2,0,2,5,4,9
1981,Pat Cummings,C,24,MIL,74,,1084,248,460,.539,0,2,.000,248,458,.541,.539,99,140,.707,97,195,292,62,31,19,114,192,595
1981,Earl Cureton,C,23,PHI,52,6,528,93,205,.454,0,1,.000,93,204,.456,.454,33,64,.516,51,104,155,25,20,23,29,68,219
1981,Bob Dandridge*,SF,33,WSB,23,,545,101,237,.426,0,1,.000,101,236,.428,.426,28,39,.718,19,64,83,60,16,9,33,54,230
1981,Adrian Dantley*,SF,25,UTA,80,,3417,909,1627,.559,2,7,.286,907,1620,.560,.559,632,784,.806,192,317,509,322,109,18,282,245,2452
1981,Brad Davis,PG,25,DAL,56,,1686,230,410,.561,3,17,.176,227,393,.578,.565,163,204,.799,29,122,151,385,52,11,123,156,626
1981,Johnny Davis,PG,25,IND,76,,2536,426,917,.465,4,33,.121,422,884,.477,.467,238,299,.796,56,114,170,480,95,14,167,179,1094
1981,Monti Davis,PF,22,TOT,2,,10,1,5,.200,0,0,,1,5,.200,.200,1,5,.200,2,2,4,0,0,1,0,0,3
1981,Monti Davis,PF,22,PHI,1,,2,1,1,1.000,0,0,,1,1,1.000,1.000,0,0,,0,1,1,0,0,0,0,0,2
1981,Monti Davis,PF,22,DAL,1,,8,0,4,.000,0,0,,0,4,.000,.000,1,5,.200,2,1,3,0,0,1,0,0,1
1981,Ron Davis,SF,26,SDC,64,,817,139,314,.443,2,8,.250,137,306,.448,.446,94,158,.595,47,72,119,47,36,11,61,98,374
1981,Walter Davis,SG,26,PHO,78,,2182,593,1101,.539,7,17,.412,586,1084,.541,.542,209,250,.836,63,137,200,302,97,12,222,192,1402
1981,Darryl Dawkins,C,24,PHI,76,76,2088,423,697,.607,0,0,,423,697,.607,.607,219,304,.720,106,439,545,109,38,112,220,316,1065
1981,Larry Demic,PF,23,NYK,76,,964,128,254,.504,0,2,.000,128,252,.508,.504,58,92,.630,114,129,243,28,12,13,58,153,314
1981,Coby Dietrick,C,32,CHI,82,,1243,146,320,.456,2,6,.333,144,314,.459,.459,77,111,.694,79,186,265,118,48,53,88,176,371
1981,James Donaldson,C,23,SEA,68,,980,129,238,.542,0,0,,129,238,.542,.542,101,170,.594,107,202,309,42,8,74,68,79,359
1981,Jacky Dorsey,SF,26,SEA,29,,253,20,70,.286,0,0,,20,70,.286,.286,13,25,.520,23,65,88,9,9,1,14,47,53
1981,Leon Douglas,C,26,KCK,79,,1356,185,323,.573,0,3,.000,185,320,.578,.573,102,186,.548,150,234,384,69,25,38,90,251,472
1981,John Drew,SF,26,ATL,67,,2075,500,1096,.456,0,7,.000,500,1089,.459,.456,454,577,.787,145,238,383,79,98,15,194,264,1454
1981,Larry Drew,PG,22,DET,76,,1581,197,484,.407,4,17,.235,193,467,.413,.411,106,133,.797,24,96,120,249,88,7,166,125,504
1981,Ralph Drollinger,C,26,DAL,6,,67,7,14,.500,0,0,,7,14,.500,.500,1,4,.250,5,14,19,14,1,2,13,16,15
1981,Terry Duerod,SG-SF,24,TOT,50,0,451,104,234,.444,8,16,.500,96,218,.440,.462,31,41,.756,17,27,44,36,17,4,35,27,247
1981,Terry Duerod,SF,24,DAL,18,,337,74,161,.460,2,6,.333,72,155,.465,.466,18,27,.667,15,24,39,30,12,4,25,19,168
1981,Terry Duerod,SG,24,BOS,32,0,114,30,73,.411,6,10,.600,24,63,.381,.452,13,14,.929,2,3,5,6,5,0,10,8,79
1981,Mike Dunleavy,SG,26,HOU,74,,1609,310,632,.491,1,16,.063,309,616,.502,.491,156,186,.839,28,90,118,268,64,2,137,165,777
1981,T.R. Dunn,SG,25,DEN,82,,1427,146,354,.412,0,2,.000,146,352,.415,.412,79,121,.653,133,168,301,81,66,29,56,141,371
1981,John Duren,PG,22,UTA,40,,458,33,101,.327,0,1,.000,33,100,.330,.327,5,9,.556,8,27,35,54,18,2,37,54,71
1981,James Edwards,C,25,IND,81,,2375,511,1004,.509,0,3,.000,511,1001,.510,.509,244,347,.703,191,380,571,212,32,128,164,304,1266
1981,Bob Elliott,C,25,NJN,73,,1320,214,419,.511,1,2,.500,213,417,.511,.512,121,202,.599,104,157,261,129,34,16,119,175,550
1981,Len Elmore,C,28,MIL,72,,925,76,212,.358,0,0,,76,212,.358,.358,54,75,.720,68,140,208,69,37,52,44,178,206
1981,Alex English*,SF,27,DEN,81,,3093,768,1555,.494,3,5,.600,765,1550,.494,.495,390,459,.850,273,373,646,290,106,100,241,255,1929
1981,Julius Erving*,SF,30,PHI,82,82,2874,794,1524,.521,4,18,.222,790,1506,.525,.522,422,536,.787,244,413,657,364,173,147,266,233,2014
1981,Mike Evans,PG,25,MIL,71,,911,134,291,.460,2,14,.143,132,277,.477,.464,50,64,.781,22,65,87,167,34,4,72,114,320
1981,Eric Fernsten,C,27,BOS,45,0,279,38,79,.481,0,0,,38,79,.481,.481,20,30,.667,29,33,62,10,6,7,20,29,96
1981,Chris Ford,SG,32,BOS,82,75,2723,314,707,.444,36,109,.330,278,598,.465,.470,64,87,.736,72,91,163,295,100,23,127,212,728
1981,Don Ford,SF,28,CLE,64,,996,100,224,.446,0,3,.000,100,221,.452,.446,22,24,.917,74,90,164,84,15,12,49,100,222
1981,Phil Ford,PG,24,KCK,66,,2287,424,887,.478,11,36,.306,413,851,.485,.484,294,354,.831,26,102,128,580,99,6,241,190,1153
1981,World B. Free,SG,27,GSW,65,,2370,516,1157,.446,5,31,.161,511,1126,.454,.448,528,649,.814,48,111,159,361,85,11,195,183,1565
1981,Tony Fuller,SG,22,DET,15,,248,24,66,.364,0,1,.000,24,65,.369,.364,12,16,.750,13,29,42,28,10,1,23,25,60
1981,Mike Gale,PG,30,TOT,77,,1112,157,309,.508,2,7,.286,155,302,.513,.511,55,68,.809,16,83,99,169,94,7,77,117,371
1981,Mike Gale,PG,30,SAS,35,,636,86,164,.524,1,3,.333,85,161,.528,.527,19,26,.731,7,45,52,99,55,2,39,56,192
1981,Mike Gale,PG,30,POR,42,,476,71,145,.490,1,4,.250,70,141,.496,.493,36,42,.857,9,38,47,70,39,5,38,61,179
1981,Calvin Garrett,SF,24,HOU,70,,1638,188,415,.453,1,3,.333,187,412,.454,.454,50,62,.806,85,179,264,132,50,10,90,167,427
1981,Gus Gerard,SF,27,TOT,27,,252,41,111,.369,0,4,.000,41,107,.383,.369,27,40,.675,30,37,67,15,10,9,15,41,109
1981,Gus Gerard,SF,27,KCK,16,,123,19,51,.373,0,3,.000,19,48,.396,.373,19,29,.655,13,16,29,6,3,6,7,24,57
1981,Gus Gerard,SF,27,SAS,11,,129,22,60,.367,0,1,.000,22,59,.373,.367,8,11,.727,17,21,38,9,7,3,8,17,52
1981,George Gervin*,SG,28,SAS,82,,2765,850,1729,.492,9,35,.257,841,1694,.496,.494,512,620,.826,126,293,419,260,94,56,251,212,2221
1981,Artis Gilmore*,C,31,CHI,82,,2832,547,816,.670,0,0,,547,816,.670,.670,375,532,.705,220,608,828,172,47,198,236,295,1469
1981,Mike Glenn,PG,25,NYK,82,,1506,285,511,.558,4,11,.364,281,500,.562,.562,98,110,.891,27,61,88,108,72,5,62,126,672
1981,Mike Gminski,C,21,NJN,56,,1579,291,688,.423,0,1,.000,291,687,.424,.423,155,202,.767,137,282,419,72,54,100,128,127,737
1981,Glen Gondrezick,PF,25,DEN,73,,1077,155,329,.471,0,2,.000,155,327,.474,.471,112,137,.818,136,171,307,83,91,20,69,185,422
1981,Rickey Green,PG,26,UTA,47,,1307,176,366,.481,0,1,.000,176,365,.482,.481,70,97,.722,30,86,116,235,75,1,83,123,422
1981,Dave Greenwood,PF,23,CHI,82,,2710,481,989,.486,0,2,.000,481,987,.487,.486,217,290,.748,243,481,724,218,77,124,192,282,1179
1981,Kevin Grevey,SG,27,WSB,75,,2616,500,1103,.453,45,136,.331,455,967,.471,.474,244,290,.841,67,152,219,300,68,17,144,161,1289
1981,Paul Griffin,PF,27,SAS,82,,1930,166,325,.511,0,0,,166,325,.511,.511,170,253,.672,184,321,505,249,77,38,132,207,502
1981,Darrell Griffith,SG,22,UTA,81,,2867,716,1544,.464,10,52,.192,706,1492,.473,.467,229,320,.716,79,209,288,194,106,40,231,219,1671
1981,Bob Gross,SF,27,POR,82,,1934,253,479,.528,0,9,.000,253,470,.538,.528,135,159,.849,126,202,328,251,90,67,151,238,641
1981,Ernie Grunfeld,SF,25,KCK,79,,1584,260,486,.535,0,0,,260,486,.535,.535,75,101,.743,31,175,206,205,60,15,88,155,595
1981,Roy Hamilton,PG,23,POR,1,,5,1,3,.333,0,0,,1,3,.333,.333,1,2,.500,2,1,3,0,0,0,1,1,3
1981,Bill Hanzlik,SF,23,SEA,74,,1259,138,289,.478,1,5,.200,137,284,.482,.479,119,150,.793,67,86,153,111,58,20,84,168,396
1981,Alan Hardy,SG,23,LAL,22,,111,22,59,.373,0,0,,22,59,.373,.373,7,10,.700,8,11,19,3,1,9,11,13,51
1981,James Hardy,PF,24,UTA,23,,509,52,111,.468,0,0,,52,111,.468,.468,11,20,.550,39,94,133,36,21,20,23,58,115
1981,Mike Harper,PF,23,POR,55,,461,56,136,.412,0,3,.000,56,133,.421,.412,37,85,.435,28,65,93,17,23,20,32,73,149
1981,Joe Hassett,SG,25,TOT,41,,714,143,340,.421,53,156,.340,90,184,.489,.499,17,21,.810,24,44,68,74,13,2,22,65,356
1981,Joe Hassett,SG,25,DAL,17,,280,59,142,.415,10,40,.250,49,102,.480,.451,10,13,.769,11,14,25,18,5,0,11,21,138
1981,Joe Hassett,SG,25,GSW,24,,434,84,198,.424,43,116,.371,41,82,.500,.533,7,8,.875,13,30,43,56,8,2,11,44,218
1981,Steve Hawes,C,30,ATL,74,,2309,333,637,.523,1,4,.250,332,633,.524,.524,222,278,.799,165,396,561,168,73,32,161,289,889
1981,Elvin Hayes*,PF,35,WSB,81,,2931,584,1296,.451,0,10,.000,584,1286,.454,.451,271,439,.617,235,554,789,98,68,171,189,300,1439
1981,Gar Heard,PF,32,SDC,78,,1631,149,396,.376,0,7,.000,149,389,.383,.376,79,101,.782,120,228,348,122,104,72,81,196,377
1981,Gerald Henderson,PG,25,BOS,82,10,1608,261,579,.451,1,16,.063,260,563,.462,.452,113,157,.720,43,89,132,213,79,12,160,177,636
1981,Tom Henderson,SG,29,HOU,66,,1411,137,332,.413,0,3,.000,137,329,.416,.413,78,95,.821,30,74,104,307,53,4,93,111,352
1981,Keith Herron,SG,24,DET,80,,2270,432,954,.453,2,11,.182,430,943,.456,.454,228,267,.854,98,113,211,148,91,26,153,154,1094
1981,Kenny Higgs,PG,26,DEN,72,,1689,209,474,.441,4,34,.118,205,440,.466,.445,140,172,.814,24,121,145,408,101,6,166,243,562
1981,Johnny High,PG,23,PHO,81,,1750,246,576,.427,2,24,.083,244,552,.442,.429,183,264,.693,89,139,228,202,129,26,188,251,677
1981,Armond Hill,PG,27,TOT,75,,1738,117,335,.349,0,7,.000,117,328,.357,.349,141,172,.820,41,118,159,292,66,11,127,207,375
1981,Armond Hill,PG,27,ATL,24,,624,39,116,.336,0,1,.000,39,115,.339,.336,42,50,.840,10,41,51,118,26,3,58,60,120
1981,Armond Hill,PG,27,SEA,51,,1114,78,219,.356,0,6,.000,78,213,.366,.356,99,122,.811,31,77,108,174,40,8,69,147,255
1981,Brad Holland,SG,24,LAL,41,,295,47,111,.423,1,3,.333,46,108,.426,.428,35,49,.714,9,20,29,23,21,1,31,44,130
1981,Lionel Hollins,PG,27,PHI,82,13,2154,327,696,.470,2,15,.133,325,681,.477,.471,125,171,.731,47,144,191,352,104,18,207,205,781
1981,Cedrick Hordges,PF,24,DEN,68,,1599,221,480,.460,0,3,.000,221,477,.463,.460,130,186,.699,120,338,458,104,33,19,120,226,572
1981,Phil Hubbard,PF,24,DET,80,,2289,433,880,.492,1,3,.333,432,877,.493,.493,294,426,.690,236,350,586,150,80,20,229,317,1161
1981,Kim Hughes,C,28,TOT,53,,490,27,70,.386,0,0,,27,70,.386,.386,1,2,.500,48,79,127,35,28,35,44,106,55
1981,Kim Hughes,C,28,DEN,8,,159,11,25,.440,0,0,,11,25,.440,.440,1,2,.500,19,31,50,11,11,14,11,33,23
1981,Kim Hughes,C,28,CLE,45,,331,16,45,.356,0,0,,16,45,.356,.356,0,0,,29,48,77,24,17,21,33,73,32
1981,Geoff Huston,PG,23,TOT,81,,2434,461,942,.489,1,5,.200,460,937,.491,.490,150,212,.708,45,93,138,394,58,7,179,148,1073
1981,Geoff Huston,PG,23,DAL,56,,1892,385,789,.488,1,4,.250,384,785,.489,.489,128,185,.692,33,66,99,277,45,6,148,113,899
1981,Geoff Huston,PG,23,CLE,25,,542,76,153,.497,0,1,.000,76,152,.500,.497,22,27,.815,12,27,39,117,13,1,31,35,174
1981,Dan Issel*,C,32,DEN,80,,2641,614,1220,.503,2,12,.167,612,1208,.507,.504,519,684,.759,229,447,676,158,83,53,130,249,1749
1981,Tony Jackson,PG,23,LAL,2,,14,1,3,.333,0,0,,1,3,.333,.333,0,0,,0,2,2,2,2,0,0,1,2
1981,Abdul Jeelani,SF,26,DAL,66,,1108,187,440,.425,0,1,.000,187,439,.426,.425,179,220,.814,83,147,230,65,44,31,87,123,553
1981,Clemon Johnson,C,24,IND,81,,1643,235,466,.504,0,1,.000,235,465,.505,.504,112,189,.593,173,295,468,144,44,119,121,185,582
1981,Dennis Johnson*,PG,26,PHO,79,,2615,532,1220,.436,11,51,.216,521,1169,.446,.441,411,501,.820,160,203,363,291,136,61,208,244,1486
1981,Eddie Johnson,SG,25,ATL,75,,2693,573,1136,.504,6,20,.300,567,1116,.508,.507,279,356,.784,60,119,179,407,126,11,197,188,1431
1981,George Johnson,C,32,SAS,82,,1935,164,347,.473,0,0,,164,347,.473,.473,80,109,.734,215,387,602,92,47,278,110,273,408
1981,George Johnson,PF,24,IND,43,,930,182,394,.462,0,5,.000,182,389,.468,.462,93,122,.762,99,179,278,86,47,23,85,120,457
1981,John Johnson,SF,33,SEA,80,,2324,373,866,.431,0,1,.000,373,865,.431,.431,173,214,.808,135,227,362,312,57,25,230,202,919
1981,Lee Johnson,PF,23,TOT,12,,90,7,25,.280,0,0,,7,25,.280,.280,3,5,.600,6,16,22,1,0,5,7,18,17
1981,Lee Johnson,PF,23,HOU,10,,80,7,23,.304,0,0,,7,23,.304,.304,3,5,.600,6,14,20,1,0,5,7,17,17
1981,Lee Johnson,PF,23,DET,2,,10,0,2,.000,0,0,,0,2,.000,.000,0,0,,0,2,2,0,0,0,0,1,0
1981,Magic Johnson*,SG,21,LAL,37,,1371,312,587,.532,3,17,.176,309,570,.542,.534,171,225,.760,101,219,320,317,127,27,143,100,798
1981,Marques Johnson,SF,24,MIL,76,,2542,636,1153,.552,0,9,.000,636,1144,.556,.552,269,381,.706,225,293,518,346,115,41,190,196,1541
1981,Mickey Johnson,PF,28,MIL,82,,2118,379,846,.448,3,18,.167,376,828,.454,.450,262,332,.789,183,362,545,286,94,71,230,256,1023
1981,Ollie Johnson,SF,31,PHI,40,,372,87,158,.551,1,6,.167,86,152,.566,.554,27,31,.871,8,47,55,30,20,2,25,45,202
1981,Reggie Johnson,PF,23,SAS,79,,1716,340,682,.499,0,1,.000,340,681,.499,.499,128,193,.663,132,226,358,78,45,48,130,283,808
1981,Vinnie Johnson,PG,24,SEA,81,,2311,419,785,.534,1,5,.200,418,780,.536,.534,214,270,.793,193,173,366,341,78,20,216,198,1053
1981,Bobby Jones*,PF,29,PHI,81,,2046,407,755,.539,0,3,.000,407,752,.541,.539,282,347,.813,142,293,435,226,95,74,149,226,1096
1981,Caldwell Jones,C,30,PHI,81,81,2639,218,485,.449,0,0,,218,485,.449,.449,148,193,.767,200,613,813,122,53,134,168,271,584
1981,Dwight Jones,PF,28,CHI,81,,1574,245,507,.483,0,0,,245,507,.483,.483,125,161,.776,127,274,401,99,40,36,126,200,615
1981,Edgar Jones,PF,24,NJN,60,,950,189,357,.529,0,4,.000,189,353,.535,.529,146,218,.670,92,171,263,43,36,81,101,185,524
1981,Major Jones,PF,27,HOU,68,,1003,117,252,.464,0,1,.000,117,251,.466,.464,64,101,.634,96,138,234,41,18,23,57,112,298
1981,Eddie Jordan,PG,26,TOT,74,,1226,150,352,.426,6,22,.273,144,330,.436,.435,87,127,.685,30,68,98,241,98,8,143,165,393
1981,Eddie Jordan,PG,26,NJN,14,,239,30,73,.411,3,10,.300,27,63,.429,.432,24,32,.750,5,13,18,46,24,1,23,29,87
1981,Eddie Jordan,PG,26,LAL,60,,987,120,279,.430,3,12,.250,117,267,.438,.435,63,95,.663,25,55,80,195,74,7,120,136,306
1981,Walter Jordan,SF,24,CLE,30,,207,29,75,.387,0,0,,29,75,.387,.387,10,17,.588,23,19,42,11,11,5,17,35,68
1981,Jeff Judkins,SF,24,UTA,62,,666,92,216,.426,9,28,.321,83,188,.441,.447,45,51,.882,29,64,93,59,16,2,30,84,238
1981,Clarence Kea,PF,21,DAL,16,,199,37,81,.457,0,1,.000,37,80,.463,.457,43,62,.694,28,39,67,5,6,1,16,44,117
1981,Rich Kelley,C,27,PHO,81,,1686,196,387,.506,0,2,.000,196,385,.509,.506,175,231,.758,131,310,441,282,79,63,209,210,567
1981,Greg Kelser,SF,23,DET,25,,654,120,285,.421,0,2,.000,120,283,.424,.421,68,106,.642,53,67,120,45,34,29,78,89,308
1981,Larry Kenon,SF,28,CHI,77,,2161,454,946,.480,0,0,,454,946,.480,.480,180,245,.735,179,219,398,120,75,18,161,160,1088
1981,Chad Kinch,SG,22,TOT,41,,353,52,141,.369,0,0,,52,141,.369,.369,14,18,.778,7,26,33,45,11,6,30,33,118
1981,Chad Kinch,SG,22,CLE,29,,247,38,96,.396,0,0,,38,96,.396,.396,4,5,.800,7,17,24,35,9,5,22,24,80
1981,Chad Kinch,SG,22,DAL,12,,106,14,45,.311,0,0,,14,45,.311,.311,10,13,.769,0,9,9,10,2,1,8,9,38
1981,Bernard King*,SF,24,GSW,81,,2914,731,1244,.588,2,6,.333,729,1238,.589,.588,307,437,.703,178,373,551,287,72,34,265,304,1771
1981,Reggie King,PF,23,KCK,81,,2743,472,867,.544,0,0,,472,867,.544,.544,264,386,.684,235,551,786,122,102,41,164,227,1208
1981,Billy Knight,SG,28,IND,82,,2385,546,1025,.533,3,19,.158,543,1006,.540,.534,341,410,.832,191,219,410,157,84,12,177,155,1436
1981,Joel Kramer,PF,25,PHO,82,,1065,136,258,.527,0,1,.000,136,257,.529,.527,63,91,.692,77,155,232,88,35,17,67,132,335
1981,Wayne Kreklow,SG,24,BOS,25,0,100,11,47,.234,1,4,.250,10,43,.233,.245,7,10,.700,2,10,12,9,2,1,10,20,30
1981,Kevin Kunnert,C,29,POR,55,,842,101,216,.468,0,0,,101,216,.468,.468,42,54,.778,98,189,287,67,17,32,50,143,244
1981,Mitch Kupchak,PF,26,WSB,82,,1934,392,747,.525,0,1,.000,392,746,.525,.525,240,340,.706,198,371,569,62,36,26,161,195,1024
1981,Sam Lacey,C,32,KCK,82,,2228,237,536,.442,1,5,.200,236,531,.444,.443,92,117,.786,131,453,584,399,95,120,182,302,567
1981,Tom LaGarde,C,25,DAL,82,,2670,417,888,.470,0,0,,417,888,.470,.470,288,444,.649,177,488,665,237,35,45,206,293,1122
1981,Bill Laimbeer,C,23,CLE,81,,2460,337,670,.503,0,0,,337,670,.503,.503,117,153,.765,266,427,693,216,56,78,132,332,791
1981,John Lambert,PF,28,TOT,46,,483,68,165,.412,0,2,.000,68,163,.417,.412,18,23,.783,28,65,93,27,12,5,19,76,154
1981,John Lambert,PF,28,CLE,3,,8,3,5,.600,0,0,,3,5,.600,.600,0,0,,1,2,3,3,0,0,2,2,6
1981,John Lambert,PF,28,KCK,43,,475,65,160,.406,0,2,.000,65,158,.411,.406,18,23,.783,27,63,90,24,12,5,17,74,148
1981,Mark Landsberger,PF,25,LAL,69,,1086,164,327,.502,0,1,.000,164,326,.503,.502,62,116,.534,152,225,377,27,19,6,65,135,390
1981,Bob Lanier*,C,32,MIL,67,,1753,376,716,.525,1,1,1.000,375,715,.524,.526,208,277,.751,128,285,413,179,73,81,139,184,961
1981,Edmund Lawrence,C,28,DET,3,,19,5,8,.625,0,0,,5,8,.625,.625,2,4,.500,2,2,4,1,1,0,1,6,12
1981,Allen Leavell,PG,23,HOU,79,,1686,258,548,.471,2,17,.118,256,531,.482,.473,124,149,.832,30,104,134,384,97,15,189,160,642
1981,Ron Lee,PG,28,DET,82,,1829,113,323,.350,2,13,.154,111,310,.358,.353,113,156,.724,65,155,220,362,166,29,173,260,341
1981,Ronnie Lester,PG,22,CHI,8,,83,10,24,.417,0,0,,10,24,.417,.417,10,11,.909,3,3,6,7,2,0,9,5,30
1981,Scott Lloyd,C,28,DAL,72,,2186,245,547,.448,0,2,.000,245,545,.450,.448,147,205,.717,161,293,454,159,34,25,145,269,637
1981,John Long,SG,24,DET,59,,1750,441,957,.461,2,11,.182,439,946,.464,.462,160,184,.870,95,102,197,106,95,22,151,164,1044
1981,John Lucas,PG,27,GSW,66,,1919,222,506,.439,4,24,.167,218,482,.452,.443,107,145,.738,34,120,154,464,83,2,185,140,555
1981,Maurice Lucas,PF,28,NJN,68,,2162,404,835,.484,0,2,.000,404,833,.485,.484,191,254,.752,153,422,575,173,57,59,176,260,999
1981,Ollie Mack,SG,23,TOT,65,,1682,279,606,.460,0,9,.000,279,597,.467,.460,80,125,.640,92,138,230,163,56,7,70,117,638
1981,Ollie Mack,SG,23,CHI,3,,16,1,6,.167,0,0,,1,6,.167,.167,1,2,.500,0,1,1,1,1,0,0,3,3
1981,Ollie Mack,SG,23,DAL,62,,1666,278,600,.463,0,9,.000,278,591,.470,.463,79,123,.642,92,137,229,162,55,7,70,114,635
1981,Kyle Macy,PG,23,PHO,82,,1469,272,532,.511,12,51,.235,260,481,.541,.523,107,119,.899,44,88,132,160,76,5,95,120,663
1981,Rick Mahorn,PF,22,WSB,52,,696,111,219,.507,0,0,,111,219,.507,.507,27,40,.675,67,148,215,25,21,44,38,134,249
1981,Moses Malone*,C,25,HOU,80,,3245,806,1545,.522,1,3,.333,805,1542,.522,.522,609,804,.757,474,706,1180,141,83,150,308,223,2222
1981,Wes Matthews,PG,21,TOT,79,,2266,385,779,.494,5,21,.238,380,758,.501,.497,202,252,.802,46,93,139,411,107,17,261,242,977
1981,Wes Matthews,PG,21,WSB,45,,1161,224,449,.499,5,15,.333,219,434,.505,.504,99,129,.767,30,37,67,199,46,10,149,120,552
1981,Wes Matthews,PG,21,ATL,34,,1105,161,330,.488,0,6,.000,161,324,.497,.488,103,123,.837,16,56,72,212,61,7,112,122,425
1981,Cedric Maxwell,SF,25,BOS,81,81,2730,441,750,.588,0,1,.000,441,749,.589,.588,352,450,.782,222,303,525,219,79,68,180,256,1234
1981,Scott May,SF,26,CHI,63,,815,165,338,.488,0,0,,165,338,.488,.488,113,149,.758,62,93,155,63,35,7,71,83,443
1981,Bill Mayfield,SF,23,GSW,7,,54,8,18,.444,0,0,,8,18,.444,.444,1,2,.500,7,2,9,1,0,1,3,8,17
1981,Bob McAdoo*,PF,29,TOT,16,,321,68,157,.433,0,1,.000,68,156,.436,.433,29,41,.707,17,50,67,30,17,13,32,38,165
1981,Bob McAdoo*,PF,29,DET,6,,168,30,82,.366,0,0,,30,82,.366,.366,12,20,.600,9,32,41,20,8,7,18,16,72
1981,Bob McAdoo*,PF,29,NJN,10,,153,38,75,.507,0,1,.000,38,74,.514,.507,17,21,.810,8,18,26,10,9,6,14,22,93
1981,Andre McCarter,PG,27,WSB,43,,448,51,135,.378,2,8,.250,49,127,.386,.385,18,24,.750,16,23,39,73,14,0,24,36,122
1981,Keith McCord,SG,23,WSB,2,,9,2,4,.500,0,0,,2,4,.500,.500,0,0,,1,1,2,1,0,0,2,0,4
1981,Jim McElroy,PG,27,ATL,54,,680,78,202,.386,1,8,.125,77,194,.397,.389,48,59,.814,10,38,48,84,20,9,79,62,205
1981,George McGinnis*,PF,30,IND,69,,1845,348,768,.453,0,7,.000,348,761,.457,.453,207,385,.538,164,364,528,210,99,28,221,242,903
1981,Kevin McHale*,PF,23,BOS,82,1,1645,355,666,.533,0,2,.000,355,664,.535,.533,108,159,.679,155,204,359,55,27,151,110,260,818
1981,Billy McKinney,PG,25,TOT,84,,2166,327,645,.507,2,12,.167,325,633,.513,.509,162,188,.862,36,148,184,360,99,11,158,231,818
1981,Billy McKinney,PG,25,UTA,35,,1032,124,233,.532,1,2,.500,123,231,.532,.534,44,48,.917,12,62,74,157,38,4,70,107,293
1981,Billy McKinney,PG,25,DEN,49,,1134,203,412,.493,1,10,.100,202,402,.502,.494,118,140,.843,24,86,110,203,61,7,88,124,525
1981,Tom McMillen,C,28,ATL,79,,1564,253,519,.487,1,6,.167,252,513,.491,.488,80,108,.741,96,199,295,72,23,25,81,165,587
1981,John Mengelt,SG,31,GSW,2,,11,0,4,.000,0,0,,0,4,.000,.000,0,0,,0,0,0,2,0,0,0,0,0
1981,Joe Meriweather,C,27,KCK,74,,1514,206,415,.496,0,0,,206,415,.496,.496,148,213,.695,126,267,393,77,27,80,125,219,560
1981,Dick Miller,SF,22,TOT,8,,53,4,9,.444,0,1,.000,4,8,.500,.444,0,0,,2,5,7,5,4,0,8,5,8
1981,Dick Miller,SF,22,IND,5,,34,2,6,.333,0,1,.000,2,5,.400,.333,0,0,,1,3,4,4,3,0,4,2,4
1981,Dick Miller,SF,22,UTA,3,,19,2,3,.667,0,0,,2,3,.667,.667,0,0,,1,2,3,1,1,0,4,3,4
1981,Mike Mitchell,SF,25,CLE,82,,3194,853,1791,.476,4,9,.444,849,1782,.476,.477,302,385,.784,215,287,502,139,63,52,175,199,2012
1981,Steve Mix,SF,33,PHI,72,1,1327,288,575,.501,0,3,.000,288,572,.503,.501,200,240,.833,105,159,264,114,59,18,88,107,776
1981,Paul Mokeski,C,24,DET,80,,1815,224,458,.489,0,1,.000,224,457,.490,.489,120,200,.600,141,277,418,135,38,73,160,267,568
1981,Sidney Moncrief*,SG,23,MIL,80,,2417,400,739,.541,2,9,.222,398,730,.545,.543,320,398,.804,186,220,406,264,90,37,145,156,1122
1981,Johnny Moore,PG,22,SAS,82,,1578,249,520,.479,1,19,.053,248,501,.495,.480,105,172,.610,58,138,196,373,120,22,154,178,604
1981,Lowes Moore,PG,23,NJN,71,,1406,212,478,.444,4,27,.148,208,451,.461,.448,69,92,.750,43,125,168,228,61,17,108,179,497
1981,Calvin Murphy*,PG,32,HOU,76,,2014,528,1074,.492,4,17,.235,524,1057,.496,.493,206,215,.958,33,54,87,222,111,6,129,209,1266
1981,Swen Nater,C,31,SDC,82,,2809,517,935,.553,0,0,,517,935,.553,.553,244,307,.795,295,722,1017,199,49,46,211,295,1278
1981,Calvin Natt,SF,24,POR,74,,2111,395,794,.497,4,8,.500,391,786,.497,.500,200,283,.707,149,282,431,159,73,18,163,188,994
1981,Kenny Natt,SG,22,IND,19,,149,25,77,.325,2,8,.250,23,69,.333,.338,7,11,.636,9,6,15,10,5,1,10,18,59
1981,Mike Newlin,SG,32,NJN,79,,2911,632,1272,.497,10,30,.333,622,1242,.501,.501,414,466,.888,78,141,219,299,87,9,248,237,1688
1981,Carl Nicks,PG,22,TOT,67,,1109,172,359,.479,0,4,.000,172,355,.485,.479,71,126,.563,37,73,110,149,60,3,116,141,415
1981,Carl Nicks,PG,22,DEN,27,,493,65,149,.436,0,1,.000,65,148,.439,.436,35,59,.593,13,36,49,80,28,2,63,52,165
1981,Carl Nicks,PG,22,UTA,40,,616,107,210,.510,0,3,.000,107,207,.517,.510,36,67,.537,24,37,61,69,32,1,53,89,250
1981,Mike Niles,SF,25,PHO,44,,231,48,138,.348,2,4,.500,46,134,.343,.355,17,37,.459,26,32,58,15,8,1,25,41,115
1981,Norm Nixon,PG,25,LAL,79,,2962,576,1210,.476,2,12,.167,574,1198,.479,.477,196,252,.778,64,168,232,696,146,11,285,226,1350
1981,Mike O'Koren,SF,22,NJN,79,,2473,365,751,.486,5,18,.278,360,733,.491,.489,135,212,.637,179,299,478,252,86,27,146,243,870
1981,Mark Olberding,SF,24,SAS,82,,2408,348,685,.508,1,7,.143,347,678,.512,.509,315,380,.829,146,325,471,277,75,31,202,307,1012
1981,Jawann Oldham,C,23,DEN,4,,21,2,6,.333,0,0,,2,6,.333,.333,0,0,,3,2,5,0,0,2,2,3,4
1981,Louis Orr,SF,22,IND,82,,1787,348,709,.491,0,6,.000,348,703,.495,.491,163,202,.807,172,189,361,132,55,25,123,153,859
1981,Tom Owens,PF,31,POR,79,,1843,322,630,.511,0,4,.000,322,626,.514,.511,191,250,.764,165,291,456,140,36,47,130,273,835
1981,Robert Parish*,C,27,BOS,82,78,2298,635,1166,.545,0,1,.000,635,1165,.545,.545,282,397,.710,245,532,777,144,81,214,191,310,1552
1981,Sonny Parker,SG,25,GSW,73,,1317,191,388,.492,0,0,,191,388,.492,.492,94,128,.734,101,93,194,106,67,13,84,112,476
1981,Myles Patrick,SF,26,LAL,3,,9,2,5,.400,0,0,,2,5,.400,.400,1,2,.500,1,1,2,1,0,0,1,3,5
1981,Billy Paultz,PF,32,HOU,81,,1659,262,517,.507,0,3,.000,262,514,.510,.507,75,153,.490,111,280,391,105,28,72,89,182,599
1981,Jim Paxson,SG,23,POR,79,,2701,585,1092,.536,2,30,.067,583,1062,.549,.537,182,248,.734,74,137,211,299,140,9,131,172,1354
1981,Sam Pellom,PF,29,ATL,77,,1472,186,380,.489,0,1,.000,186,379,.491,.489,81,116,.698,122,234,356,48,50,92,99,228,453
1981,Roger Phegley,SG,24,CLE,82,,2269,474,965,.491,8,28,.286,466,937,.497,.495,224,267,.839,90,156,246,184,65,15,165,262,1180
1981,Stan Pietkiewicz,SG,24,TOT,42,,461,57,138,.413,19,48,.396,38,90,.422,.482,11,14,.786,13,29,42,77,15,2,22,28,144
1981,Stan Pietkiewicz,SG,24,SDC,6,,30,2,5,.400,0,0,,2,5,.400,.400,0,0,,0,1,1,2,0,0,5,2,4
1981,Stan Pietkiewicz,SG,24,DAL,36,,431,55,133,.414,19,48,.396,36,85,.424,.485,11,14,.786,13,28,41,75,15,2,17,26,140
1981,Ben Poquette,PF,25,UTA,82,,2808,324,614,.528,3,6,.500,321,608,.528,.530,126,162,.778,160,469,629,161,67,174,122,342,777
1981,Kevin Porter,PG,30,WSB,81,,2577,446,859,.519,3,12,.250,443,847,.523,.521,191,247,.773,35,89,124,734,110,10,251,257,1086
1981,Tony Price,SG,24,SDC,5,,29,2,7,.286,0,0,,2,7,.286,.286,0,0,,0,0,0,3,2,1,2,3,4
1981,Wally Rank,SF,22,SDC,25,,153,21,57,.368,0,0,,21,57,.368,.368,13,28,.464,17,13,30,17,7,1,26,33,55
1981,Kelvin Ransey,PG,22,POR,80,,2431,525,1162,.452,3,31,.097,522,1131,.462,.453,164,219,.749,42,153,195,555,88,9,232,201,1217
1981,Clifford Ray,C,32,GSW,66,,838,64,152,.421,0,0,,64,152,.421,.421,29,62,.468,73,144,217,52,24,13,74,194,157
1981,James Ray,PF,23,DEN,18,,148,15,49,.306,0,1,.000,15,48,.313,.306,7,10,.700,13,24,37,11,4,4,13,31,37
1981,Billy Reid,SG,23,GSW,59,,597,84,185,.454,0,5,.000,84,180,.467,.454,22,39,.564,27,33,60,71,33,5,78,111,190
1981,Robert Reid,SF,25,HOU,82,,2963,536,1113,.482,0,4,.000,536,1109,.483,.482,229,303,.756,164,419,583,344,163,66,198,325,1301
1981,Kevin Restani,SF,29,SAS,64,,999,192,369,.520,3,8,.375,189,361,.524,.524,62,88,.705,71,103,174,81,16,14,68,103,449
1981,Clint Richardson,SG,24,PHI,77,1,1313,227,464,.489,0,1,.000,227,463,.490,.489,84,108,.778,83,93,176,152,36,10,110,102,538
1981,Micheal Ray Richardson,SG,25,NYK,79,,3175,523,1116,.469,23,102,.225,500,1014,.493,.479,224,338,.663,173,372,545,627,232,35,302,258,1293
1981,Anthony Roberts,SF,25,WSB,26,,350,54,144,.375,0,0,,54,144,.375,.375,19,29,.655,18,50,68,20,11,0,28,52,127
1981,Rick Robey,C,25,BOS,82,4,1569,298,547,.545,0,1,.000,298,546,.546,.545,144,251,.574,132,258,390,126,38,19,141,204,740
1981,Cliff Robinson,PF,20,NJN,63,,1822,525,1070,.491,1,1,1.000,524,1069,.490,.491,178,248,.718,120,361,481,105,58,52,182,216,1229
1981,Truck Robinson,PF,29,PHO,82,,3088,647,1280,.505,0,0,,647,1280,.505,.505,249,396,.629,216,573,789,206,68,38,250,220,1543
1981,Wayne Robinson,PF,22,DET,81,,1592,234,509,.460,0,6,.000,234,503,.465,.460,175,240,.729,117,177,294,112,46,24,149,186,643
1981,Bill Robinzine,PF,28,TOT,78,,2016,392,826,.475,1,6,.167,391,820,.477,.475,218,281,.776,168,365,533,118,75,9,187,275,1003
1981,Bill Robinzine,PF,28,CLE,8,,84,14,32,.438,0,0,,14,32,.438,.438,5,8,.625,4,9,13,5,4,0,10,19,33
1981,Bill Robinzine,PF,28,DAL,70,,1932,378,794,.476,1,6,.167,377,788,.478,.477,213,273,.780,164,356,520,113,71,9,177,256,970
1981,Dave Robisch,C,31,TOT,84,,2116,330,740,.446,0,0,,330,740,.446,.446,200,247,.810,157,342,499,173,37,34,83,173,860
1981,Dave Robisch,C,31,CLE,11,,372,37,98,.378,0,0,,37,98,.378,.378,29,36,.806,27,58,85,44,7,6,14,21,103
1981,Dave Robisch,C,31,DEN,73,,1744,293,642,.456,0,0,,293,642,.456,.456,171,211,.810,130,284,414,129,30,28,69,152,757
1981,John Roche,PG,31,DEN,26,,611,82,179,.458,9,27,.333,73,152,.480,.483,58,77,.753,5,32,37,140,17,8,52,44,231
1981,Tree Rollins,C,25,ATL,40,,1044,116,210,.552,0,1,.000,116,209,.555,.552,46,57,.807,102,184,286,35,29,117,57,151,278
1981,Lorenzo Romar,PG,22,GSW,53,,726,87,211,.412,2,6,.333,85,205,.415,.417,43,63,.683,10,46,56,136,27,3,52,64,219
1981,Dan Roundfield,PF,27,ATL,63,,2128,426,808,.527,0,1,.000,426,807,.528,.527,256,355,.721,231,403,634,161,76,119,178,258,1108
1981,Campy Russell,SF,29,NYK,79,,2865,508,1095,.464,8,26,.308,500,1069,.468,.468,268,343,.781,109,244,353,257,99,8,212,248,1292
1981,Frankie Sanders,SF,24,KCK,23,,186,34,77,.442,0,0,,34,77,.442,.442,20,22,.909,6,15,21,17,16,1,21,20,88
1981,DeWayne Scales,PF,22,NYK,44,,484,94,225,.418,1,6,.167,93,219,.425,.420,26,39,.667,47,85,132,10,12,4,30,54,215
1981,Alvin Scott,SF,25,PHO,82,,1423,173,348,.497,1,6,.167,172,342,.503,.499,97,127,.764,101,167,268,114,60,70,77,124,444
1981,Craig Shelton,SF,23,ATL,55,,586,100,219,.457,0,1,.000,100,218,.459,.457,35,58,.603,59,79,138,27,18,5,61,128,235
1981,Lonnie Shelton,PF,25,SEA,14,,440,73,174,.420,0,0,,73,174,.420,.420,36,55,.655,31,47,78,35,22,3,41,48,182
1981,Purvis Short,SF,23,GSW,79,,2309,549,1157,.475,3,17,.176,546,1140,.479,.476,168,205,.820,151,240,391,249,78,19,143,244,1269
1981,John Shumate,PF,28,TOT,24,,527,56,131,.427,0,0,,56,131,.427,.427,55,76,.724,34,54,88,24,21,9,42,49,167
1981,John Shumate,PF,28,SAS,22,,519,56,128,.438,0,0,,56,128,.438,.438,53,73,.726,33,54,87,24,21,9,41,46,165
1981,John Shumate,PF,28,SEA,2,,8,0,3,.000,0,0,,0,3,.000,.000,2,3,.667,1,0,1,0,0,0,1,3,2
1981,Jerry Sichting,PG,24,IND,47,,450,34,95,.358,0,5,.000,34,90,.378,.358,25,32,.781,11,32,43,70,23,1,28,38,93
1981,Jack Sikma*,C,25,SEA,82,,2920,595,1311,.454,0,5,.000,595,1306,.456,.454,340,413,.823,184,668,852,248,78,93,201,282,1530
1981,James Silas,PG,31,SAS,75,,2055,476,997,.477,0,2,.000,476,995,.478,.477,374,440,.850,44,187,231,285,51,12,159,129,1326
1981,Larry Smith,PF,23,GSW,82,,2578,304,594,.512,0,0,,304,594,.512,.512,177,301,.588,433,561,994,93,70,63,146,316,785
1981,Phil Smith,SG,28,SDC,76,,2378,519,1057,.491,4,18,.222,515,1039,.496,.493,237,313,.757,49,107,156,372,84,18,176,231,1279
1981,Randy Smith,SG,32,CLE,82,,2199,486,1043,.466,1,28,.036,485,1015,.478,.466,221,271,.815,46,147,193,357,113,14,195,132,1194
1981,Robert Smith,PG,25,CLE,1,,20,2,5,.400,0,0,,2,5,.400,.400,4,4,1.000,1,2,3,3,0,0,3,6,8
1981,Ricky Sobers,PG,28,CHI,71,,1803,355,769,.462,17,66,.258,338,703,.481,.473,231,247,.935,46,98,144,284,98,17,206,225,958
1981,Jim Spanarkel,SF,23,DAL,82,,2317,404,866,.467,1,10,.100,403,856,.471,.467,375,423,.887,142,155,297,232,117,20,172,230,1184
1981,Rory Sparrow,PG,22,NJN,15,,212,22,63,.349,0,0,,22,63,.349,.349,12,16,.750,7,11,18,32,13,3,18,15,56
1981,John Stroud,SF,23,HOU,9,,88,11,34,.324,0,0,,11,34,.324,.324,3,4,.750,7,6,13,9,1,0,4,7,25
1981,Brian Taylor,PG,29,SDC,80,,2312,310,591,.525,44,115,.383,266,476,.559,.562,146,185,.789,58,93,151,440,118,23,111,212,810
1981,Carlos Terry,SG,24,WSB,26,,504,80,160,.500,0,6,.000,80,154,.519,.500,28,42,.667,43,73,116,70,27,13,57,68,188
1981,Reggie Theus,SG,23,CHI,82,,2820,543,1097,.495,18,90,.200,525,1007,.521,.503,445,550,.809,124,163,287,426,122,20,259,258,1549
1981,David Thompson*,SG,26,DEN,77,,2620,734,1451,.506,10,39,.256,724,1412,.513,.509,489,615,.795,107,180,287,231,53,60,250,231,1967
1981,Mychal Thompson,C,26,POR,79,,2790,569,1151,.494,0,1,.000,569,1150,.495,.494,207,323,.641,223,463,686,284,62,170,241,260,1345
1981,Rudy Tomjanovich*,PF,32,HOU,52,,1264,263,563,.467,12,51,.235,251,512,.490,.478,65,82,.793,78,130,208,81,19,6,58,121,603
1981,Andrew Toney,SG,23,PHI,75,57,1768,399,806,.495,9,29,.310,390,777,.502,.501,161,226,.712,32,111,143,273,59,10,219,234,968
1981,Terry Tyler,SF,24,DET,82,,2549,476,895,.532,0,8,.000,476,887,.537,.532,148,250,.592,198,369,567,136,112,180,163,215,1100
1981,Wes Unseld*,C,34,WSB,63,,2032,225,429,.524,2,4,.500,223,425,.525,.527,55,86,.640,207,466,673,170,52,36,97,171,507
1981,Ronnie Valentine,SF,23,DEN,24,,123,37,98,.378,1,2,.500,36,96,.375,.383,9,19,.474,10,20,30,7,7,4,16,23,84
1981,Jan van Breda Kolff,SF,29,NJN,78,,1426,100,245,.408,2,8,.250,98,237,.414,.412,98,117,.838,48,154,202,129,38,50,108,214,300
1981,Kiki Vandeweghe,SF,22,DEN,51,,1376,229,537,.426,0,7,.000,229,530,.432,.426,130,159,.818,86,184,270,94,29,24,86,116,588
1981,Brett Vroman,C,25,UTA,11,,93,10,27,.370,0,1,.000,10,26,.385,.370,14,19,.737,7,18,25,9,5,5,9,26,34
1981,Foots Walker,PG,29,NJN,41,,1172,72,169,.426,2,9,.222,70,160,.438,.432,88,111,.793,22,80,102,253,52,1,85,105,234
1981,Wally Walker,SF,26,SEA,82,,1796,290,626,.463,0,3,.000,290,623,.465,.463,109,169,.645,105,210,315,122,53,15,115,168,689
1981,Lloyd Walton,PG,27,KCK,61,,821,90,218,.413,0,1,.000,90,217,.415,.413,26,33,.788,13,35,48,208,32,2,80,45,206
1981,Kermit Washington,PF,29,POR,73,,2120,325,571,.569,0,1,.000,325,570,.570,.569,181,288,.628,236,450,686,149,85,86,144,258,831
1981,Richard Washington,PF,25,TOT,80,,1812,340,747,.455,1,2,.500,339,745,.455,.456,119,159,.748,158,295,453,129,46,61,129,283,800
1981,Richard Washington,PF,25,DAL,11,,307,51,117,.436,0,0,,51,117,.436,.436,17,23,.739,25,59,84,16,5,7,21,37,119
1981,Richard Washington,PF,25,CLE,69,,1505,289,630,.459,1,2,.500,288,628,.459,.460,102,136,.750,133,236,369,113,41,54,108,246,681
1981,Marvin Webster,C,28,NYK,82,,1708,159,341,.466,1,4,.250,158,337,.469,.468,104,163,.638,162,303,465,72,27,97,103,187,423
1981,Scott Wedman,SF,28,KCK,81,,2902,685,1437,.477,25,77,.325,660,1360,.485,.485,140,204,.686,128,305,433,226,97,46,161,294,1535
1981,Paul Westphal*,SG,30,SEA,36,,1078,221,500,.442,6,25,.240,215,475,.453,.448,153,184,.832,11,57,68,148,46,14,78,70,601
1981,Jo Jo White*,PG,34,KCK,13,,236,36,82,.439,0,0,,36,82,.439,.439,11,18,.611,3,18,21,37,11,1,18,21,83
1981,Rudy White,SG,27,TOT,16,,208,23,65,.354,0,1,.000,23,64,.359,.354,15,16,.938,1,10,11,20,9,1,12,23,61
1981,Rudy White,SG,27,GSW,4,,43,9,18,.500,0,0,,9,18,.500,.500,4,4,1.000,0,0,0,2,4,0,3,7,22
1981,Rudy White,SG,27,SEA,12,,165,14,47,.298,0,1,.000,14,46,.304,.298,11,12,.917,1,10,11,18,5,1,9,16,39
1981,Jerome Whitehead,C,24,TOT,48,,688,83,180,.461,0,1,.000,83,179,.464,.461,28,56,.500,58,156,214,26,20,9,56,122,194
1981,Jerome Whitehead,C,24,DAL,7,,118,16,38,.421,0,0,,16,38,.421,.421,5,11,.455,8,20,28,2,4,1,11,16,37
1981,Jerome Whitehead,C,24,CLE,3,,8,1,3,.333,0,0,,1,3,.333,.333,0,0,,2,1,3,0,1,0,0,6,2
1981,Jerome Whitehead,C,24,SDC,38,,562,66,139,.475,0,1,.000,66,138,.478,.475,23,45,.511,48,135,183,24,15,8,45,100,155
1981,Hawkeye Whitney,SG,23,KCK,47,,782,149,306,.487,2,6,.333,147,300,.490,.490,50,65,.769,29,77,106,68,47,6,48,98,350
1981,Sidney Wicks,PF,31,SDC,49,,1083,125,286,.437,0,1,.000,125,285,.439,.437,76,150,.507,79,144,223,111,40,40,94,168,326
1981,Michael Wiley,PF,23,SAS,33,,271,76,138,.551,0,2,.000,76,136,.559,.551,36,48,.750,22,42,64,11,8,6,28,38,188
1981,Bob Wilkerson,SG,26,CHI,80,,2238,330,715,.462,1,10,.100,329,705,.467,.462,137,163,.840,86,196,282,272,102,23,175,170,798
1981,Jamaal Wilkes*,SF,27,LAL,81,,3028,786,1495,.526,1,13,.077,785,1482,.530,.526,254,335,.758,146,289,435,235,121,29,207,223,1827
1981,James Wilkes,SF,22,CHI,48,,540,85,184,.462,0,1,.000,85,183,.464,.462,29,42,.690,36,60,96,30,25,12,34,86,199
1981,Jeff Wilkins,C,25,UTA,56,,1058,117,260,.450,0,0,,117,260,.450,.450,27,40,.675,62,212,274,40,32,46,59,169,261
1981,Freeman Williams,SG,24,SDC,82,,1976,642,1381,.465,48,141,.340,594,1240,.479,.482,253,297,.852,75,54,129,164,91,5,166,157,1585
1981,Ray Williams,PG,26,NYK,79,,2742,616,1335,.461,16,68,.235,600,1267,.474,.467,312,382,.817,122,199,321,432,185,37,235,270,1560
1981,Sly Williams,PF,23,NYK,67,,1976,349,708,.493,2,8,.250,347,700,.496,.494,185,268,.690,159,257,416,180,116,18,141,199,885
1981,John Williamson,SG,29,WSB,9,,112,18,56,.321,1,6,.167,17,50,.340,.330,5,6,.833,0,7,7,17,4,1,12,13,42
1981,Bill Willoughby,SF,23,HOU,55,,1145,150,287,.523,0,0,,150,287,.523,.523,49,64,.766,74,153,227,64,18,31,74,102,349
1981,Brian Winters,SG,28,MIL,69,,1771,331,697,.475,18,51,.353,313,646,.485,.488,119,137,.869,32,108,140,229,70,10,136,185,799
1981,Mike Woodson,SG,22,NYK,81,,949,165,373,.442,1,5,.200,164,368,.446,.444,49,64,.766,33,64,97,75,36,12,54,95,380
1981,Sam Worthen,PG,23,CHI,64,,945,95,192,.495,0,4,.000,95,188,.505,.495,45,60,.750,22,93,115,115,57,6,91,115,235
1981,Larry Wright,PG,26,DET,45,,997,140,303,.462,2,7,.286,138,296,.466,.465,53,66,.803,26,62,88,153,42,7,74,114,335
1982,Kareem Abdul-Jabbar*,C,34,LAL,76,76,2677,753,1301,.579,0,3,.000,753,1298,.580,.579,312,442,.706,172,487,659,225,63,207,230,224,1818
1982,Alvan Adams,C,27,PHO,79,75,2393,507,1027,.494,0,1,.000,507,1026,.494,.494,182,233,.781,138,448,586,356,114,78,196,269,1196
1982,Mark Aguirre,SF,22,DAL,51,20,1468,381,820,.465,25,71,.352,356,749,.475,.480,168,247,.680,89,160,249,164,37,22,135,152,955
1982,Danny Ainge,SG,22,BOS,53,1,564,79,221,.357,5,17,.294,74,204,.363,.369,56,65,.862,25,31,56,87,37,3,53,86,219
1982,Tiny Archibald*,PG,33,BOS,68,51,2167,308,652,.472,6,16,.375,302,636,.475,.477,236,316,.747,25,91,116,541,52,3,178,131,858
1982,Dennis Awtrey,C,33,POR,10,3,121,5,15,.333,0,0,,5,15,.333,.333,5,9,.556,7,7,14,8,1,2,6,28,15
1982,Carl Bailey,C,23,POR,1,0,7,1,1,1.000,0,0,,1,1,1.000,1.000,0,0,,0,0,0,0,0,0,2,2,2
1982,James Bailey,PF,24,TOT,77,0,1468,261,505,.517,0,0,,261,505,.517,.517,137,224,.612,127,264,391,65,42,83,139,270,659
1982,James Bailey,PF,24,SEA,10,0,180,31,65,.477,0,0,,31,65,.477,.477,4,11,.364,17,31,48,13,3,7,19,42,66
1982,James Bailey,PF,24,NJN,67,0,1288,230,440,.523,0,0,,230,440,.523,.523,133,213,.624,110,233,343,52,39,76,120,228,593
1982,Greg Ballard,SF,27,WSB,79,79,2946,621,1307,.475,9,22,.409,612,1285,.476,.479,235,283,.830,136,497,633,250,137,22,119,204,1486
1982,Gene Banks,SF,22,SAS,80,4,1700,311,652,.477,0,8,.000,311,644,.483,.477,145,212,.684,157,254,411,147,55,17,106,199,767
1982,Mike Bantom,SF,30,TOT,82,38,2016,334,712,.469,2,6,.333,332,706,.470,.471,168,267,.629,174,266,440,114,63,61,149,272,838
1982,Mike Bantom,SF,30,IND,39,37,1037,178,406,.438,1,3,.333,177,403,.439,.440,101,153,.660,87,127,214,68,38,24,85,139,458
1982,Mike Bantom,SF,30,PHI,43,1,979,156,306,.510,1,3,.333,155,303,.512,.511,67,114,.588,87,139,226,46,25,37,64,133,380
1982,Billy Ray Bates,SG,25,POR,75,0,1229,327,692,.473,12,41,.293,315,651,.484,.481,166,211,.787,53,55,108,111,41,5,93,100,832
1982,Mel Bennett,PF,27,CLE,3,0,23,2,4,.500,0,0,,2,4,.500,.500,1,6,.167,1,2,3,0,1,0,4,2,5
1982,Kent Benson,C,27,DET,75,72,2467,405,802,.505,3,11,.273,402,791,.508,.507,127,158,.804,219,434,653,159,66,98,160,214,940
1982,Larry Bird*,PF,25,BOS,77,58,2923,711,1414,.503,11,52,.212,700,1362,.514,.507,328,380,.863,200,637,837,447,143,66,254,244,1761
1982,Otis Birdsong,SG,26,NJN,37,22,1025,225,480,.469,0,10,.000,225,470,.479,.469,74,127,.583,30,67,97,124,30,5,64,74,524
1982,Rolando Blackman,SG,22,DAL,82,16,1979,439,855,.513,1,4,.250,438,851,.515,.514,212,276,.768,97,157,254,105,46,30,113,122,1091
1982,Ray Blume,SG,23,CHI,49,2,546,102,222,.459,4,18,.222,98,204,.480,.468,18,28,.643,14,27,41,68,23,2,54,57,226
1982,Alex Bradley,SF,22,NYK,39,0,331,54,103,.524,0,1,.000,54,102,.529,.524,29,48,.604,31,34,65,11,12,5,28,37,137
1982,Charles Bradley,SG,22,BOS,51,1,339,55,122,.451,0,1,.000,55,121,.455,.451,42,62,.677,12,26,38,22,14,6,37,61,152
1982,Dudley Bradley,SG,24,PHO,64,3,937,125,281,.445,1,4,.250,124,277,.448,.447,74,100,.740,30,57,87,80,78,10,71,115,325
1982,Brad Branson,PF,23,CLE,10,3,176,21,52,.404,0,0,,21,52,.404,.404,11,12,.917,14,19,33,6,5,4,13,17,53
1982,Mike Bratz,PG,26,SAS,81,3,1616,230,565,.407,46,138,.333,184,427,.431,.448,119,152,.783,40,126,166,438,65,11,139,183,625
1982,Jim Brewer,PF,30,LAL,71,9,966,81,175,.463,1,6,.167,80,169,.473,.466,7,19,.368,106,158,264,42,39,46,37,127,170
1982,Ron Brewer,SG,26,TOT,72,45,2319,569,1194,.477,8,31,.258,561,1163,.482,.480,211,260,.812,55,106,161,188,82,30,125,151,1357
1982,Ron Brewer,SG,26,SAS,25,4,595,182,361,.504,3,10,.300,179,351,.510,.508,77,88,.875,13,37,50,67,23,7,34,37,444
1982,Ron Brewer,SG,26,CLE,47,41,1724,387,833,.465,5,21,.238,382,812,.470,.468,134,172,.779,42,69,111,121,59,23,91,114,913
1982,Junior Bridgeman,SF,28,MIL,41,4,924,209,433,.483,4,9,.444,205,424,.483,.487,89,103,.864,37,88,125,109,28,3,64,91,511
1982,Allan Bristow,SF,30,DAL,82,54,2035,218,499,.437,3,18,.167,215,481,.447,.440,134,164,.817,119,220,339,448,65,6,165,222,573
1982,Jim Brogan,SG,23,SDC,63,19,1027,165,364,.453,9,32,.281,156,332,.470,.466,61,84,.726,61,59,120,156,49,13,83,123,400
1982,Michael Brooks,SF,23,SDC,82,73,2750,537,1066,.504,0,7,.000,537,1059,.507,.504,202,267,.757,207,417,624,236,113,39,197,285,1276
1982,Fred Brown,SG,33,SEA,82,2,1785,393,863,.455,25,77,.325,368,786,.468,.470,111,129,.860,42,98,140,238,69,4,96,111,922
1982,Rickey Brown,C,23,GSW,82,11,1260,192,418,.459,0,0,,192,418,.459,.459,86,122,.705,136,228,364,19,36,29,84,243,470
1982,Joe Bryant,SF,27,SDC,75,49,1988,341,701,.486,8,30,.267,333,671,.496,.492,194,247,.785,79,195,274,189,78,29,183,250,884
1982,Quinn Buckner,PG,27,MIL,70,70,2156,396,822,.482,4,15,.267,392,807,.486,.484,110,168,.655,77,173,250,328,174,3,180,218,906
1982,Roger Burkman,SG,23,CHI,6,0,30,0,4,.000,0,1,.000,0,3,.000,.000,5,6,.833,2,4,6,5,6,2,3,6,5
1982,David Burns,PG,23,TOT,9,1,87,7,16,.438,0,0,,7,16,.438,.438,9,15,.600,1,4,5,15,3,0,13,17,23
1982,David Burns,PG,23,NJN,3,0,34,2,5,.400,0,0,,2,5,.400,.400,3,6,.500,0,2,2,4,1,0,5,4,7
1982,David Burns,PG,23,DEN,6,1,53,5,11,.455,0,0,,5,11,.455,.455,6,9,.667,1,2,3,11,2,0,8,13,16
1982,Don Buse,PG,31,IND,82,78,2529,312,685,.455,73,189,.386,239,496,.482,.509,100,123,.813,46,177,223,407,164,27,95,176,797
1982,Kenny Carr,PF,26,TOT,74,48,1926,348,692,.503,1,10,.100,347,682,.509,.504,198,302,.656,167,364,531,86,64,22,152,249,895
1982,Kenny Carr,PF,26,CLE,46,42,1482,271,524,.517,1,9,.111,270,515,.524,.518,145,220,.659,114,280,394,63,58,16,112,180,688
1982,Kenny Carr,PF,26,DET,28,6,444,77,168,.458,0,1,.000,77,167,.461,.458,53,82,.646,53,84,137,23,6,6,40,69,207
1982,M.L. Carr,SF,31,BOS,56,27,1296,184,409,.450,5,17,.294,179,392,.457,.456,82,116,.707,56,94,150,128,67,21,63,136,455
1982,Joe Barry Carroll,C,23,GSW,76,75,2627,527,1016,.519,0,1,.000,527,1015,.519,.519,235,323,.728,210,423,633,64,64,127,206,265,1289
1982,Butch Carter,SG,23,IND,75,0,1035,188,402,.468,8,25,.320,180,377,.477,.478,58,70,.829,30,49,79,60,34,11,54,110,442
1982,Reggie Carter,SG,24,NYK,75,1,923,119,280,.425,0,0,,119,280,.425,.425,64,80,.800,35,60,95,130,36,6,78,124,302
1982,Bill Cartwright,C,24,NYK,72,50,2060,390,694,.562,0,0,,390,694,.562,.562,257,337,.763,116,305,421,87,48,65,166,208,1037
1982,Harvey Catchings,PF,30,MIL,80,9,1603,94,224,.420,0,0,,94,224,.420,.420,41,69,.594,129,227,356,97,42,134,94,237,229
1982,Bobby Cattage,PF,23,UTA,49,0,337,60,135,.444,0,2,.000,60,133,.451,.444,30,41,.732,22,51,73,7,7,0,18,58,150
1982,Tom Chambers,PF,22,SDC,81,58,2682,554,1056,.525,0,2,.000,554,1054,.526,.525,284,458,.620,211,350,561,146,58,46,220,341,1392
1982,Maurice Cheeks*,PG,25,PHI,79,79,2498,352,676,.521,6,22,.273,346,654,.529,.525,171,220,.777,51,197,248,667,209,33,184,247,881
1982,Jim Chones,C,32,WSB,59,13,867,74,171,.433,0,0,,74,171,.433,.433,36,46,.783,39,146,185,64,15,32,41,114,184
1982,Don Collins,SG,23,WSB,79,18,1609,334,653,.511,1,12,.083,333,641,.520,.512,121,169,.716,101,95,196,148,89,24,135,195,790
1982,Darwin Cook,PG,23,NJN,82,17,2090,387,803,.482,7,31,.226,380,772,.492,.486,118,162,.728,52,103,155,319,146,24,175,196,899
1982,Jeff Cook,PF,25,PHO,76,22,1298,151,358,.422,0,2,.000,151,356,.424,.422,89,134,.664,112,189,301,100,37,23,80,174,391
1982,Joe Cooper,C,24,NJN,1,0,11,1,2,.500,0,0,,1,2,.500,.500,0,0,,1,1,2,0,0,0,1,2,2
1982,Michael Cooper,SG,25,LAL,76,14,2197,383,741,.517,2,17,.118,381,724,.526,.518,139,171,.813,84,185,269,230,120,61,151,216,907
1982,Wayne Cooper,C,25,DAL,76,38,1818,281,669,.420,1,8,.125,280,661,.424,.421,119,160,.744,200,350,550,115,37,106,88,285,682
1982,Hollis Copeland,SF,26,NYK,18,0,118,16,38,.421,0,0,,16,38,.421,.421,5,6,.833,3,2,5,9,4,2,4,19,37
1982,Dave Corzine,C,25,SAS,82,21,2189,336,648,.519,1,4,.250,335,644,.520,.519,159,213,.746,211,418,629,130,33,126,139,235,832
1982,Charlie Criss,PG,33,TOT,55,20,1392,222,498,.446,10,29,.345,212,469,.452,.456,141,159,.887,13,69,82,187,44,6,82,96,595
1982,Charlie Criss,PG,33,ATL,27,0,552,84,210,.400,2,8,.250,82,202,.406,.405,65,73,.890,6,32,38,75,23,2,30,40,235
1982,Charlie Criss,PG,33,SDC,28,20,840,138,288,.479,8,21,.381,130,267,.487,.493,76,86,.884,7,37,44,112,21,4,52,56,360
1982,Geoff Crompton,C,26,MIL,35,1,203,11,32,.344,0,0,,11,32,.344,.344,6,15,.400,10,31,41,13,6,12,17,39,28
1982,Pat Cummings,PF,25,MIL,78,7,1132,219,430,.509,0,2,.000,219,428,.512,.509,67,91,.736,61,184,245,99,22,9,108,227,505
1982,Earl Cureton,PF,24,PHI,66,8,956,149,306,.487,0,2,.000,149,304,.490,.487,51,94,.543,90,180,270,32,31,27,44,142,349
1982,Bob Dandridge*,SF,34,MIL,11,0,174,21,55,.382,0,0,,21,55,.382,.382,10,17,.588,4,13,17,13,5,2,11,25,52
1982,Adrian Dantley*,SF,26,UTA,81,81,3222,904,1586,.570,1,3,.333,903,1583,.570,.570,648,818,.792,231,283,514,324,95,14,299,252,2457
1982,Brad Davis,PG,26,DAL,82,82,2614,397,771,.515,14,49,.286,383,722,.530,.524,185,230,.804,35,191,226,509,73,6,159,218,993
1982,Charles Davis,SF,23,WSB,54,10,575,88,184,.478,0,2,.000,88,182,.484,.478,30,37,.811,54,79,133,31,10,13,43,89,206
1982,Johnny Davis,SG,26,IND,82,70,2664,538,1153,.467,5,27,.185,533,1126,.473,.469,315,394,.799,72,106,178,346,76,11,186,176,1396
1982,Ron Davis,SF,27,SDC,7,0,67,10,25,.400,0,0,,10,25,.400,.400,3,6,.500,7,6,13,4,0,0,5,8,23
1982,Walter Davis,SF,27,PHO,55,12,1182,350,669,.523,3,16,.188,347,653,.531,.525,91,111,.820,21,82,103,162,46,3,112,104,794
1982,Darryl Dawkins,C,25,PHI,48,36,1124,207,367,.564,0,2,.000,207,365,.567,.564,114,164,.695,68,237,305,55,19,55,96,193,528
1982,Larry Demic,PF,24,NYK,48,0,356,39,83,.470,0,1,.000,39,82,.476,.470,14,39,.359,29,50,79,14,4,6,26,65,92
1982,Kenny Dennard,PF,23,KCK,30,3,607,62,121,.512,0,0,,62,121,.512,.512,26,40,.650,47,86,133,42,35,8,35,81,150
1982,Coby Dietrick,C,33,CHI,74,0,999,92,200,.460,0,1,.000,92,199,.462,.460,38,54,.704,63,125,188,87,49,30,44,131,222
1982,Mickey Dillard,PG,23,CLE,33,0,221,29,79,.367,0,4,.000,29,75,.387,.367,15,23,.652,6,9,15,34,8,2,17,40,73
1982,James Donaldson,C,24,SEA,82,1,1710,255,419,.609,0,0,,255,419,.609,.609,151,240,.629,138,352,490,51,27,139,115,186,661
1982,John Douglas,SG,25,SDC,64,9,1031,181,389,.465,18,59,.305,163,330,.494,.488,67,102,.657,27,63,90,146,48,9,92,147,447
1982,Leon Douglas,C,27,KCK,63,17,1093,70,140,.500,0,0,,70,140,.500,.500,32,80,.400,111,179,290,35,15,38,55,210,172
1982,John Drew,SF,27,ATL,70,51,2040,465,957,.486,4,12,.333,461,945,.488,.488,364,491,.741,169,206,375,96,64,3,178,250,1298
1982,Larry Drew,PG,23,KCK,81,19,1973,358,757,.473,8,27,.296,350,730,.479,.478,150,189,.794,30,119,149,419,110,1,174,150,874
1982,Terry Duerod,SG,25,BOS,21,0,146,34,77,.442,0,1,.000,34,76,.447,.442,4,12,.333,6,9,15,12,3,1,2,9,72
1982,Mike Dunleavy,SG,27,HOU,70,15,1315,206,450,.458,33,86,.384,173,364,.475,.494,75,106,.708,24,80,104,227,45,3,80,161,520
1982,T.R. Dunn,SG,26,DEN,82,80,2519,258,504,.512,0,1,.000,258,503,.513,.512,153,215,.712,211,348,559,188,135,36,123,210,669
1982,John Duren,PG,23,UTA,79,9,1056,121,268,.451,3,11,.273,118,257,.459,.457,27,37,.730,14,70,84,157,20,4,72,143,272
1982,Craig Dykema,SF,22,PHO,32,0,103,17,37,.459,2,4,.500,15,33,.455,.486,7,9,.778,3,9,12,15,2,0,7,19,43
1982,Franklin Edwards,PG,22,PHI,42,3,291,65,150,.433,0,9,.000,65,141,.461,.433,20,27,.741,10,17,27,45,16,5,24,37,150
1982,James Edwards,C,26,CLE,77,75,2539,528,1033,.511,0,4,.000,528,1029,.513,.511,232,339,.684,189,392,581,123,24,117,162,347,1288
1982,Len Elmore,C,29,NJN,81,70,2100,300,652,.460,0,0,,300,652,.460,.460,135,170,.794,167,274,441,100,92,92,136,280,735
1982,Alex English*,SF,28,DEN,82,82,3015,855,1553,.551,0,8,.000,855,1545,.553,.551,372,443,.840,210,348,558,433,87,120,261,261,2082
1982,Julius Erving*,SF,31,PHI,81,81,2789,780,1428,.546,3,11,.273,777,1417,.548,.547,411,539,.763,220,337,557,319,161,141,214,229,1974
1982,Mike Evans,PG,26,TOT,22,0,270,35,86,.407,0,6,.000,35,80,.438,.407,13,20,.650,5,17,22,42,13,0,26,36,83
1982,Mike Evans,PG,26,MIL,14,0,196,24,51,.471,0,2,.000,24,49,.490,.471,8,12,.667,3,9,12,22,9,0,15,26,56
1982,Mike Evans,PG,26,CLE,8,0,74,11,35,.314,0,4,.000,11,31,.355,.314,5,8,.625,2,8,10,20,4,0,11,10,27
1982,Eric Fernsten,C,28,BOS,43,0,202,19,49,.388,0,0,,19,49,.388,.388,19,30,.633,12,30,42,8,5,7,13,23,57
1982,Chris Ford,SG,33,BOS,76,53,1591,188,450,.418,20,63,.317,168,387,.434,.440,39,56,.696,52,56,108,142,42,10,52,143,435
1982,Don Ford,SF,29,CLE,21,1,201,9,24,.375,0,1,.000,9,23,.391,.375,5,6,.833,14,21,35,11,8,0,15,30,23
1982,Phil Ford,PG,25,KCK,72,65,1952,285,649,.439,7,32,.219,278,617,.451,.445,136,166,.819,24,81,105,451,63,1,194,160,713
1982,World B. Free,SG,28,GSW,78,78,2796,650,1452,.448,10,56,.179,640,1396,.458,.451,479,647,.740,118,130,248,419,71,8,208,222,1789
1982,Mike Gale,PG,31,GSW,75,70,1793,185,373,.496,0,5,.000,185,368,.503,.496,51,65,.785,37,152,189,261,121,28,126,173,421
1982,Calvin Garrett,SF,25,HOU,51,22,858,105,242,.434,3,10,.300,102,232,.440,.440,17,26,.654,27,67,94,76,32,6,38,94,230
1982,George Gervin*,SG,29,SAS,79,79,2817,993,1987,.500,10,36,.278,983,1951,.504,.502,555,642,.864,138,254,392,187,77,45,210,215,2551
1982,Artis Gilmore*,C,32,CHI,82,82,2796,546,837,.652,1,1,1.000,545,836,.652,.653,424,552,.768,224,611,835,136,49,220,227,287,1517
1982,Mike Glenn,SG,26,ATL,49,0,833,158,291,.543,1,2,.500,157,289,.543,.545,59,67,.881,5,56,61,87,26,3,27,80,376
1982,Mike Gminski,C,22,NJN,64,6,740,119,270,.441,0,0,,119,270,.441,.441,97,118,.822,70,116,186,41,17,48,56,69,335
1982,Glen Gondrezick,SF,26,DEN,80,0,1699,250,495,.505,0,3,.000,250,492,.508,.505,160,217,.737,140,283,423,152,92,36,100,229,660
1982,Rickey Green,PG,27,UTA,81,73,2822,500,1015,.493,0,8,.000,500,1007,.497,.493,202,264,.765,85,158,243,630,185,9,198,183,1202
1982,Dave Greenwood,PF,24,CHI,82,82,2914,480,1014,.473,0,3,.000,480,1011,.475,.473,240,291,.825,192,594,786,262,70,93,180,292,1200
1982,Kevin Grevey,SG,28,WSB,71,62,2164,376,857,.439,28,82,.341,348,775,.449,.455,165,193,.855,57,138,195,149,44,23,96,151,945
1982,Paul Griffin,PF,28,SAS,23,0,459,32,66,.485,0,0,,32,66,.485,.485,24,37,.649,29,66,95,54,20,8,40,67,88
1982,Darrell Griffith,SG,23,UTA,80,79,2597,689,1429,.482,15,52,.288,674,1377,.489,.487,189,271,.697,128,177,305,187,95,34,193,213,1582
1982,Bob Gross,SF,28,POR,59,24,1377,173,322,.537,3,6,.500,170,316,.538,.542,78,104,.750,101,158,259,125,75,41,88,162,427
1982,Ernie Grunfeld,SG,26,KCK,81,11,1892,420,822,.511,2,14,.143,418,808,.517,.512,188,229,.821,55,127,182,276,72,39,148,191,1030
1982,Pétur Guðmundsson,C,23,POR,68,6,845,83,166,.500,1,1,1.000,82,165,.497,.503,52,76,.684,51,135,186,59,13,30,73,163,219
1982,Glenn Hagan,PG,26,DET,4,0,25,3,7,.429,0,0,,3,7,.429,.429,1,1,1.000,2,2,4,8,3,0,1,7,7
1982,Bill Hanzlik,SF,24,SEA,81,76,1974,167,357,.468,0,4,.000,167,353,.473,.468,138,176,.784,99,167,266,183,81,30,106,250,472
1982,Alan Hardy,SG,24,DET,38,0,310,62,136,.456,0,5,.000,62,131,.473,.456,18,29,.621,14,20,34,20,9,4,20,32,142
1982,James Hardy,SF,25,UTA,82,17,1814,179,369,.485,0,1,.000,179,368,.486,.485,64,93,.688,153,317,470,110,58,67,78,192,422
1982,Mike Harper,PF,24,POR,68,38,1433,184,370,.497,0,1,.000,184,369,.499,.497,96,153,.627,127,212,339,54,55,82,92,229,464
1982,Joe Hassett,SG,26,GSW,68,2,787,144,382,.377,71,214,.332,73,168,.435,.470,31,37,.838,13,40,53,104,30,3,36,94,390
1982,Steve Hawes,PF,31,ATL,49,42,1317,178,370,.481,4,10,.400,174,360,.483,.486,96,126,.762,89,231,320,142,36,34,87,156,456
1982,Elvin Hayes*,PF,36,HOU,82,82,3032,519,1100,.472,0,5,.000,519,1095,.474,.472,280,422,.664,267,480,747,144,62,104,208,287,1318
1982,Steve Hayes,C,26,TOT,35,0,487,54,111,.486,0,0,,54,111,.486,.486,32,53,.604,39,78,117,28,4,20,19,71,140
1982,Steve Hayes,C,26,SAS,9,0,75,8,18,.444,0,0,,8,18,.444,.444,7,12,.583,7,10,17,4,1,2,2,17,23
1982,Steve Hayes,C,26,DET,26,0,412,46,93,.495,0,0,,46,93,.495,.495,25,41,.610,32,68,100,24,3,18,17,54,117
1982,Spencer Haywood*,PF,32,WSB,76,63,2086,395,829,.476,0,3,.000,395,826,.478,.476,219,260,.842,144,278,422,64,45,68,175,249,1009
1982,Gerald Henderson,PG,26,BOS,82,31,1844,353,705,.501,2,12,.167,351,693,.506,.502,125,172,.727,47,105,152,252,82,11,150,199,833
1982,Tom Henderson,SG,30,HOU,75,23,1721,183,403,.454,0,2,.000,183,401,.456,.454,105,150,.700,33,105,138,306,55,7,105,120,471
1982,Keith Herron,SG,25,CLE,30,0,269,39,106,.368,0,1,.000,39,105,.371,.368,7,8,.875,10,11,21,23,8,2,12,25,85
1982,Kenny Higgs,PG,27,DEN,76,49,1696,202,468,.432,4,21,.190,198,447,.443,.436,161,197,.817,23,121,144,395,72,6,156,263,569
1982,Armond Hill,PG,28,TOT,40,18,723,53,126,.421,0,2,.000,53,124,.427,.421,39,55,.709,12,40,52,106,21,5,66,88,145
1982,Armond Hill,PG,28,SEA,21,4,243,19,37,.514,0,0,,19,37,.514,.514,17,23,.739,6,19,25,25,5,2,14,37,55
1982,Armond Hill,PG,28,SDC,19,14,480,34,89,.382,0,2,.000,34,87,.391,.382,22,32,.688,6,21,27,81,16,3,52,51,90
1982,Brad Holland,SG,25,TOT,14,3,194,27,78,.346,0,3,.000,27,75,.360,.346,3,6,.500,6,7,13,18,11,1,8,13,57
1982,Brad Holland,SG,25,WSB,13,3,185,27,73,.370,0,3,.000,27,70,.386,.370,3,4,.750,6,7,13,16,11,1,7,12,57
1982,Brad Holland,SG,25,MIL,1,0,9,0,5,.000,0,0,,0,5,.000,.000,0,2,.000,0,0,0,2,0,0,1,1,0
1982,Lionel Hollins,PG,28,PHI,81,81,2257,380,797,.477,2,16,.125,378,781,.484,.478,132,188,.702,35,152,187,316,103,20,146,198,894
1982,Cedrick Hordges,PF,25,DEN,77,1,1372,204,414,.493,3,13,.231,201,401,.501,.496,116,199,.583,119,276,395,65,26,19,111,230,527
1982,Phil Hubbard,SF,25,TOT,83,40,1839,326,665,.490,0,4,.000,326,661,.493,.490,191,280,.682,187,286,473,91,65,19,161,292,843
1982,Phil Hubbard,SF,25,DET,52,38,1104,207,410,.505,0,3,.000,207,407,.509,.505,106,163,.650,101,171,272,67,38,16,99,176,520
1982,Phil Hubbard,SF,25,CLE,31,2,735,119,255,.467,0,1,.000,119,254,.469,.467,85,117,.726,86,115,201,24,27,3,62,116,323
1982,Geoff Huston,PG,24,CLE,78,43,2409,325,672,.484,3,10,.300,322,662,.486,.486,153,200,.765,53,97,150,590,70,11,171,169,806
1982,Dan Issel*,C,33,DEN,81,81,2472,651,1236,.527,4,6,.667,647,1230,.526,.528,546,655,.834,174,434,608,179,67,55,169,245,1852
1982,Tracy Jackson,SG,22,TOT,49,0,478,79,172,.459,0,0,,79,172,.459,.459,38,49,.776,35,28,63,27,14,3,24,48,196
1982,Tracy Jackson,SG,22,BOS,11,0,66,10,26,.385,0,0,,10,26,.385,.385,6,10,.600,7,5,12,5,3,0,6,5,26
1982,Tracy Jackson,SG,22,CHI,38,0,412,69,146,.473,0,0,,69,146,.473,.473,32,39,.821,28,23,51,22,11,3,18,43,170
1982,Clay Johnson,SG,25,LAL,7,0,65,11,20,.550,0,0,,11,20,.550,.550,3,6,.500,8,4,12,7,3,3,7,13,25
1982,Clemon Johnson,C,25,IND,79,42,1979,312,641,.487,0,0,,312,641,.487,.487,123,189,.651,184,387,571,127,60,112,138,241,747
1982,Dennis Johnson*,SG,27,PHO,80,77,2937,577,1228,.470,8,42,.190,569,1186,.480,.473,399,495,.806,142,268,410,369,105,55,233,253,1561
1982,Eddie Johnson,SG,26,ATL,68,57,2314,455,1011,.450,7,30,.233,448,981,.457,.454,294,385,.764,63,128,191,358,102,16,186,188,1211
1982,Eddie Johnson,SF,22,KCK,74,27,1517,295,643,.459,1,11,.091,294,632,.465,.460,99,149,.664,128,194,322,109,50,14,97,210,690
1982,Frank Johnson,PG,23,WSB,79,29,2027,336,812,.414,17,79,.215,319,733,.435,.424,153,204,.750,34,113,147,380,76,7,160,196,842
1982,George Johnson,C,33,SAS,75,62,1578,91,195,.467,0,0,,91,195,.467,.467,43,64,.672,152,302,454,79,20,234,92,259,225
1982,George Johnson,PF,25,IND,59,4,720,120,291,.412,0,2,.000,120,289,.415,.412,60,80,.750,72,145,217,40,36,25,68,147,300
1982,John Johnson,SF,34,SEA,14,1,187,22,45,.489,0,0,,22,45,.489,.489,15,20,.750,3,15,18,29,4,3,17,20,59
1982,Magic Johnson*,SG,22,LAL,78,77,2991,556,1036,.537,6,29,.207,550,1007,.546,.540,329,433,.760,252,499,751,743,208,34,286,223,1447
1982,Marques Johnson,SF,25,MIL,60,52,1900,404,760,.532,0,4,.000,404,756,.534,.532,182,260,.700,153,211,364,213,59,35,145,142,990
1982,Mickey Johnson,PF,29,MIL,76,71,1934,372,757,.491,1,7,.143,371,750,.495,.492,233,291,.801,133,321,454,215,72,45,191,240,978
1982,Ollie Johnson,SF,32,PHI,26,0,150,27,54,.500,1,3,.333,26,51,.510,.509,6,7,.857,7,15,22,10,13,3,13,28,61
1982,Reggie Johnson,PF,24,TOT,75,48,1904,351,662,.530,0,1,.000,351,661,.531,.530,118,156,.756,140,311,451,73,33,60,100,257,820
1982,Reggie Johnson,PF,24,SAS,21,17,504,94,194,.485,0,0,,94,194,.485,.485,32,40,.800,43,94,137,20,7,16,26,67,220
1982,Reggie Johnson,PF,24,CLE,23,22,617,94,175,.537,0,0,,94,175,.537,.537,35,44,.795,43,82,125,22,6,17,24,73,223
1982,Reggie Johnson,PF,24,KCK,31,9,783,163,293,.556,0,1,.000,163,292,.558,.556,51,72,.708,54,135,189,31,20,27,50,117,377
1982,Steve Johnson,C,24,KCK,78,50,1741,395,644,.613,0,0,,395,644,.613,.613,212,330,.642,152,307,459,91,39,89,197,372,1002
1982,Vinnie Johnson,SG,25,TOT,74,15,1295,217,444,.489,3,12,.250,214,432,.495,.492,107,142,.754,82,77,159,171,56,25,96,101,544
1982,Vinnie Johnson,SG,25,SEA,7,0,104,9,22,.409,0,1,.000,9,21,.429,.409,9,12,.750,7,8,15,11,6,2,5,8,27
1982,Vinnie Johnson,SG,25,DET,67,15,1191,208,422,.493,3,11,.273,205,411,.499,.496,98,130,.754,75,69,144,160,50,23,91,93,517
1982,Bobby Jones*,PF,30,PHI,76,73,2181,416,737,.564,0,3,.000,416,734,.567,.564,263,333,.790,109,284,393,189,99,112,145,211,1095
1982,Caldwell Jones,C,31,PHI,81,47,2446,231,465,.497,0,3,.000,231,462,.500,.497,179,219,.817,164,544,708,100,38,146,155,301,641
1982,Dwight Jones,PF,29,CHI,78,18,2040,303,572,.530,1,1,1.000,302,571,.529,.531,172,238,.723,156,351,507,114,49,36,155,217,779
1982,Edgar Jones,PF,25,DET,48,19,802,142,259,.548,1,2,.500,141,257,.549,.550,90,129,.698,70,137,207,40,28,92,66,149,375
1982,Major Jones,PF,28,HOU,60,6,746,113,213,.531,0,3,.000,113,210,.538,.531,42,77,.545,80,122,202,25,20,29,50,100,268
1982,Eddie Jordan,PG,27,LAL,58,0,608,89,208,.428,1,9,.111,88,199,.442,.430,43,54,.796,4,39,43,131,62,1,66,98,222
1982,Jeff Judkins,SF,25,DET,30,0,251,31,81,.383,1,10,.100,30,71,.423,.389,16,26,.615,14,20,34,14,6,5,9,33,79
1982,Clarence Kea,PF,22,DAL,35,0,248,26,49,.531,0,0,,26,49,.531,.531,29,42,.690,26,35,61,14,4,3,16,55,81
1982,Rich Kelley,C,28,PHO,81,39,1892,236,505,.467,0,1,.000,236,504,.468,.467,167,223,.749,168,329,497,293,64,71,244,292,639
1982,Greg Kelser,SF,24,TOT,60,10,741,116,271,.428,0,3,.000,116,268,.433,.428,105,160,.656,80,113,193,57,18,21,84,131,337
1982,Greg Kelser,SF,24,DET,11,0,183,35,86,.407,0,3,.000,35,83,.422,.407,27,41,.659,13,26,39,12,5,7,22,32,97
1982,Greg Kelser,SF,24,SEA,49,10,558,81,185,.438,0,0,,81,185,.438,.438,78,119,.655,67,87,154,45,13,14,62,99,240
1982,Larry Kenon,PF,29,CHI,60,30,1036,192,412,.466,0,0,,192,412,.466,.466,50,88,.568,72,108,180,65,30,7,82,71,434
1982,Albert King,SF,22,NJN,76,52,1694,391,812,.482,3,13,.231,388,799,.486,.483,133,171,.778,105,207,312,142,64,36,180,261,918
1982,Bernard King*,SF,25,GSW,79,77,2861,740,1307,.566,1,5,.200,739,1302,.568,.567,352,499,.705,140,329,469,282,78,23,267,285,1833
1982,Reggie King,SF,24,KCK,80,76,2609,383,752,.509,0,0,,383,752,.509,.509,201,285,.705,162,361,523,173,84,29,155,221,967
1982,Billy Knight,SF,29,IND,81,19,1803,378,764,.495,9,32,.281,369,732,.504,.501,233,282,.826,97,160,257,118,63,14,137,132,998
1982,Toby Knight,SF,26,NYK,40,0,550,102,183,.557,0,0,,102,183,.557,.557,17,25,.680,33,49,82,23,14,11,21,74,221
1982,Joel Kramer,PF,26,PHO,56,0,549,55,133,.414,0,0,,55,133,.414,.414,33,42,.786,36,72,108,51,19,11,26,62,143
1982,Kevin Kunnert,C,30,POR,21,0,237,20,48,.417,0,0,,20,48,.417,.417,9,17,.529,20,46,66,18,3,6,18,51,49
1982,Mitch Kupchak,PF,27,LAL,26,26,821,153,267,.573,0,0,,153,267,.573,.573,65,98,.663,64,146,210,33,12,10,43,80,371
1982,Sam Lacey,C,33,TOT,56,7,670,67,154,.435,0,1,.000,67,153,.438,.435,27,37,.730,20,87,107,77,22,38,56,139,161
1982,Sam Lacey,C,33,KCK,2,1,20,3,5,.600,0,0,,3,5,.600,.600,0,2,.000,0,4,4,4,2,1,2,2,6
1982,Sam Lacey,C,33,NJN,54,6,650,64,149,.430,0,1,.000,64,148,.432,.430,27,35,.771,20,83,103,73,20,37,54,137,155
1982,Tom LaGarde,C,26,DAL,47,28,909,113,269,.420,0,2,.000,113,267,.423,.420,86,166,.518,63,147,210,49,17,17,82,138,312
1982,Bill Laimbeer,C,24,TOT,80,34,1829,265,536,.494,4,13,.308,261,523,.499,.498,184,232,.793,234,383,617,100,39,64,121,296,718
1982,Bill Laimbeer,C,24,CLE,50,4,894,119,253,.470,3,6,.500,116,247,.470,.476,93,120,.775,124,153,277,45,22,30,61,170,334
1982,Bill Laimbeer,C,24,DET,30,30,935,146,283,.516,1,7,.143,145,276,.525,.518,91,112,.813,110,230,340,55,17,34,60,126,384
1982,John Lambert,PF,29,TOT,63,7,764,86,197,.437,1,7,.143,85,190,.447,.439,34,42,.810,55,123,178,37,18,16,48,123,207
1982,John Lambert,PF,29,KCK,42,1,493,60,139,.432,1,6,.167,59,133,.444,.435,21,28,.750,36,91,127,24,12,10,38,80,142
1982,John Lambert,PF,29,SAS,21,6,271,26,58,.448,0,1,.000,26,57,.456,.448,13,14,.929,19,32,51,13,6,6,10,43,65
1982,Jeff Lamp,SF,22,POR,54,0,617,100,196,.510,0,1,.000,100,195,.513,.510,50,61,.820,24,40,64,28,16,1,45,83,250
1982,Mark Landsberger,PF,26,LAL,75,1,1134,144,329,.438,0,2,.000,144,327,.440,.438,33,65,.508,164,237,401,32,10,7,49,134,321
1982,Bob Lanier*,C,33,MIL,74,72,1986,407,729,.558,0,2,.000,407,727,.560,.558,182,242,.752,92,296,388,219,72,56,166,211,996
1982,Allen Leavell,PG,24,HOU,79,61,2150,370,793,.467,9,31,.290,361,762,.474,.472,115,135,.852,49,119,168,457,150,15,153,182,864
1982,Rock Lee,C,26,SDC,2,0,10,1,2,.500,0,0,,1,2,.500,.500,0,4,.000,0,1,1,2,0,0,0,3,2
1982,Ron Lee,PG,29,DET,81,7,1467,88,246,.358,18,59,.305,70,187,.374,.394,84,119,.706,35,120,155,312,116,20,123,221,278
1982,Ronnie Lester,PG,23,CHI,75,74,2252,329,657,.501,4,8,.500,325,649,.501,.504,208,256,.813,75,138,213,362,80,14,185,158,870
1982,Alton Lister,C,23,MIL,80,23,1186,149,287,.519,0,0,,149,287,.519,.519,64,123,.520,108,279,387,84,18,118,129,239,362
1982,Lewis Lloyd,SG,22,GSW,16,0,95,25,45,.556,0,0,,25,45,.556,.556,7,11,.636,9,7,16,6,5,1,14,20,57
1982,Scott Lloyd,PF,29,DAL,74,17,1047,108,285,.379,2,4,.500,106,281,.377,.382,69,91,.758,60,103,163,67,15,7,59,175,287
1982,Kevin Loder,SF,22,KCK,71,13,1139,208,448,.464,0,11,.000,208,437,.476,.464,77,107,.720,69,126,195,88,35,30,68,147,493
1982,John Long,SG,25,DET,69,66,2211,637,1294,.492,2,15,.133,635,1279,.496,.493,238,275,.865,95,162,257,148,65,25,167,173,1514
1982,John Lucas,PG,28,WSB,79,53,1940,263,618,.426,2,22,.091,261,596,.438,.427,138,176,.784,40,126,166,551,95,6,156,105,666
1982,Maurice Lucas,PF,29,NYK,80,74,2671,505,1001,.504,0,3,.000,505,998,.506,.504,253,349,.725,274,629,903,179,68,70,173,309,1263
1982,Ollie Mack,SG,24,DAL,13,3,150,19,59,.322,0,2,.000,19,57,.333,.322,6,8,.750,8,10,18,14,5,1,4,6,44
1982,Rudy Macklin,SF,23,ATL,79,32,1516,210,484,.434,0,3,.000,210,481,.437,.434,134,173,.775,113,150,263,47,40,20,112,225,554
1982,Kyle Macy,PG,24,PHO,82,72,2845,486,945,.514,39,100,.390,447,845,.529,.535,152,169,.899,78,183,261,384,143,9,125,185,1163
1982,Rick Mahorn,PF,23,WSB,80,80,2664,414,816,.507,0,3,.000,414,813,.509,.507,148,234,.632,149,555,704,150,57,138,162,349,976
1982,Moses Malone*,C,26,HOU,81,81,3398,945,1822,.519,0,6,.000,945,1816,.520,.519,630,827,.762,558,630,1188,142,76,125,294,208,2520
1982,Wes Matthews,PG,22,ATL,47,5,837,131,298,.440,2,8,.250,129,290,.445,.443,60,79,.759,19,39,58,139,53,2,63,129,324
1982,Cedric Maxwell,SF,26,BOS,78,73,2590,397,724,.548,0,3,.000,397,721,.551,.548,357,478,.747,218,281,499,183,79,49,174,263,1151
1982,Scott May,SF,27,MIL,65,7,1187,212,417,.508,0,4,.000,212,413,.513,.508,159,193,.824,85,133,218,133,50,6,92,151,583
1982,Bob McAdoo*,C,30,LAL,41,0,746,151,330,.458,0,5,.000,151,325,.465,.458,90,126,.714,45,114,159,32,22,36,51,109,392
1982,John McCullough,SG,25,PHO,8,0,23,9,13,.692,0,0,,9,13,.692,.692,3,5,.600,1,3,4,3,2,0,3,3,21
1982,Hank McDowell,PF,22,GSW,30,1,335,34,84,.405,0,0,,34,84,.405,.405,27,41,.659,41,59,100,20,6,8,21,52,95
1982,Jim McElroy,PG,28,ATL,20,17,349,52,125,.416,1,5,.200,51,120,.425,.420,29,36,.806,6,11,17,39,8,3,22,44,134
1982,Mike McGee,SF,22,LAL,39,0,352,80,172,.465,0,4,.000,80,168,.476,.465,31,53,.585,34,15,49,16,18,3,34,59,191
1982,George McGinnis*,PF,31,IND,76,4,1341,141,378,.373,0,3,.000,141,375,.376,.373,72,159,.453,93,305,398,204,96,28,131,198,354
1982,Kevin McHale*,PF,24,BOS,82,33,2332,465,875,.531,0,0,,465,875,.531,.531,187,248,.754,191,365,556,91,30,185,137,264,1117
1982,Kevin McKenna,SG,23,LAL,36,0,237,28,87,.322,0,2,.000,28,85,.329,.322,11,17,.647,18,11,29,14,10,2,20,45,67
1982,Billy McKinney,PG,26,DEN,81,27,1963,369,699,.528,0,17,.000,369,682,.541,.528,137,170,.806,29,113,142,338,69,16,115,186,875
1982,Tom McMillen,C,29,ATL,73,23,1792,291,572,.509,1,3,.333,290,569,.510,.510,140,170,.824,102,234,336,129,25,24,124,202,723
1982,Joe Meriweather,C,28,KCK,18,10,380,47,91,.516,0,0,,47,91,.516,.516,31,40,.775,25,63,88,17,13,21,25,68,125
1982,Mike Mitchell,SF,26,TOT,84,83,3063,753,1477,.510,0,7,.000,753,1470,.512,.510,220,302,.728,244,346,590,82,60,43,153,277,1726
1982,Mike Mitchell,SF,26,CLE,27,26,973,229,504,.454,0,6,.000,229,498,.460,.454,72,100,.720,71,70,141,39,27,15,55,77,530
1982,Mike Mitchell,SF,26,SAS,57,57,2090,524,973,.539,0,1,.000,524,972,.539,.539,148,202,.733,173,276,449,43,33,28,98,200,1196
1982,Steve Mix,SF,34,PHI,75,0,1235,202,399,.506,1,4,.250,201,395,.509,.508,136,172,.791,92,133,225,93,42,17,67,86,541
1982,Paul Mokeski,C,25,TOT,67,4,868,84,193,.435,0,3,.000,84,190,.442,.435,48,63,.762,59,149,208,35,33,40,55,171,216
1982,Paul Mokeski,C,25,DET,39,3,523,49,111,.441,0,1,.000,49,110,.445,.441,25,33,.758,35,87,122,24,13,23,39,103,123
1982,Paul Mokeski,C,25,CLE,28,1,345,35,82,.427,0,2,.000,35,80,.438,.427,23,30,.767,24,62,86,11,20,17,16,68,93
1982,Sidney Moncrief*,SG,24,MIL,80,80,2980,556,1063,.523,1,14,.071,555,1049,.529,.524,468,573,.817,221,313,534,382,138,22,208,206,1581
1982,Johnny Moore,PG,23,SAS,79,78,2294,309,667,.463,1,21,.048,308,646,.477,.464,122,182,.670,62,213,275,762,163,12,175,254,741
1982,Lowes Moore,PG,24,CLE,4,0,70,19,38,.500,1,5,.200,18,33,.545,.513,6,8,.750,1,3,4,15,6,1,5,15,45
1982,Calvin Murphy*,PG,33,HOU,64,0,1204,277,648,.427,1,16,.063,276,632,.437,.428,100,110,.909,20,41,61,163,43,1,82,142,655
1982,Larry Nance,PF,22,PHO,80,0,1186,227,436,.521,0,1,.000,227,435,.522,.521,75,117,.641,95,161,256,82,42,71,104,169,529
1982,Swen Nater,C,32,SDC,21,7,575,101,175,.577,1,1,1.000,100,174,.575,.580,59,79,.747,46,146,192,30,6,9,48,64,262
1982,Calvin Natt,SF,25,POR,75,71,2599,515,894,.576,2,8,.250,513,886,.579,.577,294,392,.750,193,420,613,150,62,36,140,175,1326
1982,Mike Newlin,SG,33,NYK,76,32,1507,286,615,.465,7,23,.304,279,592,.471,.471,126,147,.857,36,55,91,170,33,3,104,194,705
1982,Carl Nicks,SG,23,UTA,80,1,1322,252,555,.454,0,5,.000,252,550,.458,.454,85,150,.567,67,94,161,89,66,4,101,184,589
1982,Kurt Nimphius,C,23,DAL,63,27,1085,137,297,.461,0,0,,137,297,.461,.461,63,108,.583,92,203,295,61,17,82,56,190,337
1982,Norm Nixon,PG,26,LAL,82,82,3024,628,1274,.493,3,12,.250,625,1262,.495,.494,181,224,.808,38,138,176,652,132,7,238,264,1440
1982,Mike O'Koren,SF,23,NJN,80,32,2018,383,778,.492,8,23,.348,375,755,.497,.497,135,189,.714,111,194,305,192,83,13,147,175,909
1982,Mark Olberding,PF,25,SAS,68,63,2098,333,705,.472,2,12,.167,331,693,.478,.474,273,338,.808,118,321,439,202,57,29,139,253,941
1982,Jawann Oldham,C,24,HOU,22,0,124,13,36,.361,0,0,,13,36,.361,.361,8,14,.571,7,17,24,3,2,10,6,28,34
1982,Louis Orr,SF,23,IND,80,41,1951,357,719,.497,1,8,.125,356,711,.501,.497,203,254,.799,127,204,331,134,56,26,137,182,918
1982,Tom Owens,PF,32,IND,74,40,1599,299,636,.470,1,2,.500,298,634,.470,.471,181,226,.801,142,230,372,127,41,37,137,259,780
1982,Robert Parish*,C,28,BOS,80,78,2534,669,1235,.542,0,0,,669,1235,.542,.542,252,355,.710,288,578,866,140,68,192,221,267,1590
1982,Sonny Parker,SF,26,GSW,71,0,899,116,245,.473,0,0,,116,245,.473,.473,48,72,.667,73,104,177,89,39,11,51,101,280
1982,Billy Paultz,C,33,HOU,65,3,807,89,226,.394,0,0,,89,226,.394,.394,34,65,.523,54,126,180,41,15,22,45,99,212
1982,Jim Paxson,SG,24,POR,82,82,2756,662,1258,.526,8,35,.229,654,1223,.535,.529,220,287,.767,75,146,221,276,129,12,144,159,1552
1982,Sam Pellom,PF,30,ATL,69,4,1037,114,251,.454,0,1,.000,114,250,.456,.454,61,79,.772,90,139,229,28,29,47,57,164,289
1982,Roger Phegley,SG,25,TOT,81,9,1183,233,507,.460,5,31,.161,228,476,.479,.464,85,109,.780,61,93,154,114,36,8,66,152,556
1982,Roger Phegley,SG,25,CLE,27,8,566,104,214,.486,4,13,.308,100,201,.498,.495,36,45,.800,28,43,71,53,16,2,33,61,248
1982,Roger Phegley,SG,25,SAS,54,1,617,129,293,.440,1,18,.056,128,275,.465,.442,49,64,.766,33,50,83,61,20,6,33,91,308
1982,Ben Poquette,PF,26,UTA,82,56,1698,220,428,.514,3,10,.300,217,418,.519,.518,97,120,.808,117,294,411,94,51,65,69,235,540
1982,Mark Radford,SG,22,SEA,43,0,369,54,100,.540,2,3,.667,52,97,.536,.550,35,69,.507,13,16,29,57,16,2,42,65,145
1982,Ed Rains,SF,25,SAS,49,15,637,77,177,.435,0,2,.000,77,175,.440,.435,38,64,.594,37,43,80,40,18,2,25,74,192
1982,Kurt Rambis,PF,23,LAL,64,43,1131,118,228,.518,0,1,.000,118,227,.520,.518,59,117,.504,116,232,348,56,60,76,77,167,295
1982,Kelvin Ransey,PG,23,POR,78,68,2418,504,1095,.460,3,38,.079,501,1057,.474,.462,242,318,.761,39,147,186,555,97,4,229,169,1253
1982,James Ray,PF,24,DEN,40,4,262,51,116,.440,1,1,1.000,50,115,.435,.444,21,36,.583,18,47,65,26,10,16,37,59,124
1982,Robert Reid,SF,26,HOU,77,75,2913,437,958,.456,1,10,.100,436,948,.460,.457,160,214,.748,175,336,511,314,115,48,157,297,1035
1982,Kevin Restani,PF,30,TOT,47,0,483,32,88,.364,0,2,.000,32,86,.372,.364,10,16,.625,39,73,112,22,11,11,20,56,74
1982,Kevin Restani,PF,30,SAS,13,0,145,9,28,.321,0,1,.000,9,27,.333,.321,3,4,.750,8,27,35,7,1,4,6,16,21
1982,Kevin Restani,PF,30,CLE,34,0,338,23,60,.383,0,1,.000,23,59,.390,.383,7,12,.583,31,46,77,15,10,7,14,40,53
1982,Clint Richardson,SG,25,PHI,77,0,1040,140,310,.452,2,2,1.000,138,308,.448,.455,69,88,.784,55,63,118,109,36,9,79,109,351
1982,Micheal Ray Richardson,PG,26,NYK,82,79,3044,619,1343,.461,19,101,.188,600,1242,.483,.468,212,303,.700,177,388,565,572,213,41,291,317,1469
1982,Rick Robey,C,26,BOS,80,4,1186,185,375,.493,0,2,.000,185,373,.496,.493,84,157,.535,114,181,295,68,27,14,92,183,454
1982,Cliff Robinson,PF,21,TOT,68,59,2175,518,1143,.453,0,4,.000,518,1139,.455,.453,222,313,.709,174,435,609,120,88,103,149,222,1258
1982,Cliff Robinson,PF,21,KCK,38,30,1229,322,708,.455,0,3,.000,322,705,.457,.455,125,180,.694,83,239,322,71,46,60,86,120,769
1982,Cliff Robinson,PF,21,CLE,30,29,946,196,435,.451,0,1,.000,196,434,.452,.451,97,133,.729,91,196,287,49,42,43,63,102,489
1982,Jackie Robinson,SF,26,CHI,3,0,29,3,9,.333,0,0,,3,9,.333,.333,4,4,1.000,3,0,3,0,0,0,1,1,10
1982,Truck Robinson,PF,30,PHO,74,72,2745,579,1128,.513,1,1,1.000,578,1127,.513,.514,255,371,.687,202,519,721,179,42,28,202,215,1414
1982,Bill Robinzine,PF,29,UTA,56,9,651,131,294,.446,0,0,,131,294,.446,.446,61,75,.813,56,88,144,49,37,5,83,156,323
1982,Dave Robisch,C,32,DEN,12,0,257,48,106,.453,0,0,,48,106,.453,.453,48,55,.873,14,49,63,32,3,4,13,29,144
1982,John Roche,SG,32,DEN,39,2,501,68,150,.453,23,52,.442,45,98,.459,.530,28,38,.737,4,19,23,89,15,2,29,40,187
1982,Tree Rollins,C,26,ATL,79,39,2018,202,346,.584,0,0,,202,346,.584,.584,79,129,.612,168,443,611,59,35,224,79,285,483
1982,Lorenzo Romar,PG,23,GSW,79,11,1259,203,403,.504,3,15,.200,200,388,.515,.507,79,96,.823,12,86,98,226,60,13,89,103,488
1982,Dan Roundfield,PF,28,ATL,61,58,2217,424,910,.466,1,5,.200,423,905,.467,.466,285,375,.760,227,494,721,162,64,93,183,210,1134
1982,Jeff Ruland,C,23,WSB,82,0,2214,420,749,.561,1,3,.333,419,746,.562,.561,342,455,.752,253,509,762,134,44,58,237,319,1183
1982,Campy Russell,SF,30,NYK,77,63,2358,410,858,.478,25,57,.439,385,801,.481,.492,228,294,.776,86,150,236,284,77,12,195,221,1073
1982,DeWayne Scales,PF,23,NYK,3,0,24,1,5,.200,0,0,,1,5,.200,.200,1,2,.500,2,3,5,0,1,1,2,3,3
1982,Danny Schayes,C,22,UTA,82,20,1623,252,524,.481,0,1,.000,252,523,.482,.481,140,185,.757,131,296,427,146,46,72,151,292,644
1982,Alvin Scott,SF,26,PHO,81,38,1740,189,380,.497,0,2,.000,189,378,.500,.497,108,148,.730,97,197,294,149,59,70,98,169,486
1982,Craig Shelton,SF,24,ATL,4,0,21,2,6,.333,0,0,,2,6,.333,.333,1,2,.500,1,2,3,0,1,0,0,3,5
1982,Lonnie Shelton,PF,26,SEA,81,81,2667,508,1046,.486,0,8,.000,508,1038,.489,.486,188,240,.783,161,348,509,252,99,43,199,317,1204
1982,Purvis Short,SF,24,GSW,76,8,1782,456,935,.488,6,28,.214,450,907,.496,.491,177,221,.801,123,143,266,209,65,10,122,220,1095
1982,Jerry Sichting,PG,25,IND,51,0,800,91,194,.469,1,9,.111,90,185,.486,.472,29,38,.763,14,41,55,117,33,1,42,63,212
1982,Jack Sikma*,C,26,SEA,82,82,3049,581,1212,.479,2,13,.154,579,1199,.483,.480,447,523,.855,223,815,1038,277,102,107,213,268,1611
1982,James Silas,SG,32,CLE,67,34,1447,251,573,.438,0,5,.000,251,568,.442,.438,246,286,.860,26,83,109,222,40,6,107,109,748
1982,Jim Smith,PF,23,SDC,72,3,858,86,169,.509,0,0,,86,169,.509,.509,39,85,.459,72,110,182,46,22,51,47,185,211
1982,Larry Smith,PF,24,GSW,74,55,2213,220,412,.534,0,1,.000,220,411,.535,.534,88,159,.553,279,534,813,83,65,54,105,291,528
1982,Phil Smith,SG,29,TOT,74,41,2042,340,761,.447,5,27,.185,335,734,.456,.450,163,223,.731,51,135,186,307,67,27,155,213,848
1982,Phil Smith,SG,29,SDC,48,39,1446,253,575,.440,5,24,.208,248,551,.450,.444,123,168,.732,34,83,117,233,45,19,116,151,634
1982,Phil Smith,SG,29,SEA,26,2,596,87,186,.468,0,3,.000,87,183,.475,.468,40,55,.727,17,52,69,74,22,8,39,62,214
1982,Randy Smith,SG,33,NYK,82,40,2033,348,748,.465,3,11,.273,345,737,.468,.467,122,151,.808,53,102,155,255,91,1,124,199,821
1982,Robert Smith,PG,26,MIL,17,1,316,52,110,.473,2,10,.200,50,100,.500,.482,10,12,.833,1,13,14,44,10,1,14,35,116
1982,Ricky Sobers,SG,29,CHI,80,6,1938,363,801,.453,19,76,.250,344,725,.474,.465,195,254,.768,37,105,142,301,73,18,217,238,940
1982,Jim Spanarkel,SG,24,DAL,82,1,1755,270,564,.479,8,24,.333,262,540,.485,.486,279,327,.853,99,111,210,206,86,9,111,140,827
1982,Rory Sparrow,PG,23,ATL,82,82,2610,366,730,.501,1,15,.067,365,715,.510,.502,124,148,.838,53,171,224,424,87,13,145,240,857
1982,Larry Spriggs,SF,22,HOU,4,0,37,7,11,.636,0,0,,7,11,.636,.636,0,2,.000,2,4,6,4,2,0,4,7,14
1982,Kevin Stacom,SG,30,MIL,7,0,90,14,34,.412,1,2,.500,13,32,.406,.426,1,2,.500,2,5,7,7,1,0,9,6,30
1982,Brian Taylor,PG,30,SDC,41,40,1274,165,328,.503,23,63,.365,142,265,.536,.538,90,110,.818,26,70,96,229,47,9,82,113,443
1982,Carlos Terry,SG,25,WSB,13,0,60,3,15,.200,0,3,.000,3,12,.250,.200,3,4,.750,5,7,12,8,3,1,5,15,9
1982,Reggie Theus,SG,24,CHI,82,82,2838,560,1194,.469,25,100,.250,535,1094,.489,.479,363,449,.808,115,197,312,476,87,16,277,243,1508
1982,Isiah Thomas*,PG,20,DET,72,72,2433,453,1068,.424,17,59,.288,436,1009,.432,.432,302,429,.704,57,152,209,565,150,17,299,253,1225
1982,David Thompson*,SG,27,DEN,61,5,1246,313,644,.486,4,14,.286,309,630,.490,.489,276,339,.814,57,91,148,117,34,29,142,149,906
1982,Mychal Thompson,C,27,POR,79,78,3129,681,1303,.523,0,0,,681,1303,.523,.523,280,446,.628,258,663,921,319,69,107,245,233,1642
1982,Ray Tolbert,PF,23,TOT,64,0,607,100,202,.495,0,2,.000,100,200,.500,.495,19,35,.543,50,76,126,33,12,16,45,83,219
1982,Ray Tolbert,PF,23,NJN,12,0,115,20,44,.455,0,1,.000,20,43,.465,.455,4,8,.500,11,16,27,8,4,2,12,19,44
1982,Ray Tolbert,PF,23,SEA,52,0,492,80,158,.506,0,1,.000,80,157,.510,.506,15,27,.556,39,60,99,25,8,14,33,64,175
1982,Andrew Toney,SG,24,PHI,77,1,1909,511,979,.522,25,59,.424,486,920,.528,.535,227,306,.742,43,91,134,283,64,17,214,269,1274
1982,Raymond Townsend,SG,26,IND,14,0,95,11,41,.268,2,9,.222,9,32,.281,.293,11,20,.550,2,11,13,10,3,0,6,18,35
1982,Kelly Tripucka,SF,22,DET,82,82,3077,636,1281,.496,5,22,.227,631,1259,.501,.498,495,621,.797,219,224,443,270,89,16,280,241,1772
1982,Elston Turner,SF,22,DAL,80,62,1996,282,639,.441,0,4,.000,282,635,.444,.441,97,138,.703,143,158,301,189,75,2,116,182,661
1982,Terry Tyler,PF,25,DET,82,0,1989,336,643,.523,1,4,.250,335,639,.524,.523,142,192,.740,154,339,493,126,77,160,121,182,815
1982,Darnell Valentine,PG,22,POR,82,14,1387,187,453,.413,0,9,.000,187,444,.421,.413,152,200,.760,48,101,149,270,94,3,127,187,526
1982,Jan van Breda Kolff,SF,30,NJN,41,0,452,41,82,.500,0,2,.000,41,80,.513,.500,62,76,.816,17,31,48,32,12,13,29,63,144
1982,Kiki Vandeweghe,PF,23,DEN,82,78,2775,706,1260,.560,1,13,.077,705,1247,.565,.561,347,405,.857,149,312,461,247,52,29,189,217,1760
1982,Pete Verhoeven,PF,22,POR,71,22,1207,149,296,.503,0,0,,149,296,.503,.503,51,72,.708,106,148,254,52,42,22,55,215,349
1982,Jay Vincent,PF,22,DAL,81,62,2626,719,1448,.497,1,4,.250,718,1444,.497,.497,293,409,.716,182,383,565,176,89,22,194,308,1732
1982,Danny Vranes,SF,23,SEA,77,1,1075,143,262,.546,0,1,.000,143,261,.548,.546,89,148,.601,71,127,198,56,28,21,68,150,375
1982,Foots Walker,PG,30,NJN,77,54,1861,156,378,.413,3,9,.333,153,369,.415,.417,141,194,.727,31,119,150,398,120,6,107,179,456
1982,Wally Walker,SF,27,SEA,70,70,1965,302,629,.480,0,2,.000,302,627,.482,.480,90,134,.672,108,197,305,218,36,28,111,215,694
1982,Kermit Washington,PF,30,POR,20,4,418,38,78,.487,0,0,,38,78,.487,.487,24,41,.585,40,77,117,29,9,16,19,56,100
1982,Richard Washington,PF,26,CLE,18,2,313,50,115,.435,0,2,.000,50,113,.442,.435,9,15,.600,32,43,75,15,8,2,35,51,109
1982,Marvin Webster,C,29,NYK,82,32,1883,199,405,.491,0,0,,199,405,.491,.491,108,170,.635,184,306,490,99,22,91,90,211,506
1982,Scott Wedman,SF,29,CLE,54,39,1638,260,589,.441,5,23,.217,255,566,.451,.446,66,90,.733,128,176,304,133,73,14,73,189,591
1982,Paul Westphal*,SG,31,NYK,18,12,451,86,194,.443,2,8,.250,84,186,.452,.448,36,47,.766,9,13,22,100,19,8,47,61,210
1982,Jerome Whitehead,C,25,SDC,72,63,2214,406,726,.559,0,0,,406,726,.559,.559,184,241,.763,231,433,664,102,48,44,141,290,996
1982,Hawkeye Whitney,SG,24,KCK,23,4,266,25,71,.352,0,1,.000,25,70,.357,.352,4,7,.571,13,27,40,19,12,1,14,31,54
1982,Michael Wiley,PF,24,SDC,61,1,1013,203,359,.565,0,5,.000,203,354,.573,.565,98,141,.695,67,115,182,52,40,16,71,127,504
1982,Bob Wilkerson,SF,27,CLE,65,38,1805,284,679,.418,3,18,.167,281,661,.425,.420,145,185,.784,60,190,250,237,92,25,138,188,716
1982,Jamaal Wilkes*,SF,28,LAL,82,82,2906,744,1417,.525,0,4,.000,744,1413,.527,.525,246,336,.732,153,240,393,143,89,24,164,240,1734
1982,James Wilkes,SF,23,CHI,57,22,862,128,266,.481,0,1,.000,128,265,.483,.481,58,80,.725,62,97,159,64,30,18,62,112,314
1982,Jeff Wilkins,C,26,UTA,82,62,2274,314,718,.437,0,3,.000,314,715,.439,.437,137,176,.778,120,491,611,90,32,77,134,248,765
1982,Buck Williams,PF,21,NJN,82,82,2825,513,881,.582,0,1,.000,513,880,.583,.582,242,388,.624,347,658,1005,107,84,84,235,285,1268
1982,Freeman Williams,SG,25,TOT,60,10,997,276,623,.443,28,94,.298,248,529,.469,.465,140,166,.843,23,39,62,86,29,0,107,103,720
1982,Freeman Williams,SG,25,SDC,37,10,808,234,513,.456,24,74,.324,210,439,.478,.480,118,140,.843,21,29,50,67,23,0,89,85,610
1982,Freeman Williams,SG,25,ATL,23,0,189,42,110,.382,4,20,.200,38,90,.422,.400,22,26,.846,2,10,12,19,6,0,18,18,110
1982,Gus Williams,PG,28,SEA,80,80,2876,773,1592,.486,9,40,.225,764,1552,.492,.488,320,436,.734,92,152,244,549,172,36,197,163,1875
1982,Herb Williams,C,23,IND,82,75,2277,407,854,.477,2,7,.286,405,847,.478,.478,126,188,.670,175,430,605,139,53,178,137,200,942
1982,Ray Williams,SG,27,NJN,82,69,2732,639,1383,.462,9,54,.167,630,1329,.474,.465,387,465,.832,117,208,325,488,199,43,290,302,1674
1982,Sam Williams,PF,22,GSW,59,22,1073,154,277,.556,0,0,,154,277,.556,.556,49,89,.551,91,217,308,38,45,76,64,156,357
1982,Sly Williams,SF,24,NYK,60,27,1521,349,628,.556,2,9,.222,347,619,.561,.557,131,173,.757,100,127,227,142,77,16,114,153,831
1982,Bill Willoughby,SF,24,HOU,69,42,1475,240,464,.517,3,7,.429,237,457,.519,.520,56,77,.727,107,157,264,75,31,59,78,146,539
1982,Brian Winters,SG,29,MIL,61,13,1829,404,806,.501,36,93,.387,368,713,.516,.524,123,156,.788,51,119,170,253,57,9,118,187,967
1982,Garry Witts,SF,22,WSB,46,0,493,49,84,.583,1,2,.500,48,82,.585,.589,33,40,.825,29,33,62,38,17,4,35,74,132
1982,Al Wood,SG,23,TOT,48,5,930,179,381,.470,3,24,.125,176,357,.493,.474,93,119,.782,51,83,134,58,31,9,71,108,454
1982,Al Wood,SG,23,ATL,19,0,238,36,105,.343,0,6,.000,36,99,.364,.343,20,28,.714,22,22,44,11,9,1,11,34,92
1982,Al Wood,SG,23,SDC,29,5,692,143,276,.518,3,18,.167,140,258,.543,.524,73,91,.802,29,61,90,47,22,8,60,74,362
1982,Howard Wood,SF,22,UTA,42,3,342,55,120,.458,0,1,.000,55,119,.462,.458,34,52,.654,22,43,65,9,8,6,15,37,144
1982,Mike Woodson,SG,23,TOT,83,74,2331,538,1069,.503,7,25,.280,531,1044,.509,.507,221,286,.773,102,145,247,222,142,35,153,220,1304
1982,Mike Woodson,SG,23,NJN,7,0,145,30,68,.441,0,1,.000,30,67,.448,.441,23,32,.719,5,8,13,16,7,2,9,21,83
1982,Mike Woodson,SG,23,KCK,76,74,2186,508,1001,.507,7,24,.292,501,977,.513,.511,198,254,.780,97,137,234,206,135,33,144,199,1221
1982,Orlando Woolridge,SF,22,CHI,75,12,1188,202,394,.513,0,3,.000,202,391,.517,.513,144,206,.699,82,145,227,81,23,24,107,152,548
1982,Sam Worthen,PG,24,UTA,5,0,22,2,5,.400,0,0,,2,5,.400,.400,0,0,,1,0,1,3,0,0,2,3,4
1982,Larry Wright,PG,27,DET,1,0,6,0,1,.000,0,0,,0,1,.000,.000,0,0,,0,0,0,0,0,0,1,2,0
1982,Rich Yonakor,PF,23,SAS,10,0,70,14,26,.538,0,0,,14,26,.538,.538,5,7,.714,13,14,27,3,1,2,2,7,33
1983,Kareem Abdul-Jabbar*,C,35,LAL,79,79,2554,722,1228,.588,0,2,.000,722,1226,.589,.588,278,371,.749,167,425,592,200,61,170,200,220,1722
1983,Alvan Adams,C,28,PHO,80,75,2447,477,981,.486,1,3,.333,476,978,.487,.487,180,217,.829,161,387,548,376,114,74,242,287,1135
1983,Mark Aguirre,SF,23,DAL,81,75,2784,767,1589,.483,16,76,.211,751,1513,.496,.488,429,589,.728,191,317,508,332,80,26,261,247,1979
1983,Danny Ainge,SG,23,BOS,80,76,2048,357,720,.496,5,29,.172,352,691,.509,.499,72,97,.742,83,131,214,251,109,6,98,259,791
1983,Dwight Anderson,PG,22,DEN,5,0,33,7,14,.500,0,0,,7,14,.500,.500,7,10,.700,0,2,2,3,1,0,5,7,21
1983,J.J. Anderson,SF,22,TOT,65,2,1202,190,379,.501,0,4,.000,190,375,.507,.501,100,175,.571,119,175,294,67,63,21,79,153,480
1983,J.J. Anderson,SF,22,PHI,13,0,48,8,22,.364,0,1,.000,8,21,.381,.364,1,3,.333,4,8,12,1,1,0,5,6,17
1983,J.J. Anderson,SF,22,UTA,52,2,1154,182,357,.510,0,3,.000,182,354,.514,.510,99,172,.576,115,167,282,66,62,21,74,147,463
1983,Richard Anderson,C,22,SDC,78,5,1274,174,431,.404,7,19,.368,167,412,.405,.412,48,69,.696,111,161,272,120,57,26,93,170,403
1983,Tiny Archibald*,PG,34,BOS,66,19,1811,235,553,.425,5,24,.208,230,529,.435,.429,220,296,.743,25,66,91,409,38,4,163,110,695
1983,John Bagley,PG,22,CLE,68,3,990,161,373,.432,0,14,.000,161,359,.448,.432,64,84,.762,17,79,96,167,54,5,118,74,386
1983,James Bailey,PF,25,TOT,75,39,1765,385,774,.497,0,1,.000,385,773,.498,.497,226,322,.702,171,303,474,67,43,60,196,271,996
1983,James Bailey,PF,25,NJN,6,0,50,9,18,.500,0,0,,9,18,.500,.500,2,2,1.000,3,3,6,2,1,1,6,15,20
1983,James Bailey,PF,25,HOU,69,39,1715,376,756,.497,0,1,.000,376,755,.498,.497,224,320,.700,168,300,468,65,42,59,190,256,976
1983,Greg Ballard,SF,28,WSB,78,78,2840,603,1274,.473,13,37,.351,590,1237,.477,.478,182,233,.781,123,385,508,262,135,25,157,176,1401
1983,Gene Banks,PF,23,SAS,81,81,2722,505,919,.550,0,5,.000,505,914,.553,.550,196,278,.705,222,390,612,279,78,21,171,229,1206
1983,Billy Ray Bates,SG,26,TOT,19,3,304,55,145,.379,2,5,.400,53,140,.379,.386,11,22,.500,11,8,19,14,14,3,12,19,123
1983,Billy Ray Bates,SG,26,WSB,15,3,277,53,129,.411,2,5,.400,51,124,.411,.419,10,20,.500,10,8,18,14,13,3,12,18,118
1983,Billy Ray Bates,SG,26,LAL,4,0,27,2,16,.125,0,0,,2,16,.125,.125,1,2,.500,1,0,1,0,1,0,0,1,5
1983,Dave Batton,C,26,WSB,54,5,558,85,191,.445,0,3,.000,85,188,.452,.445,8,17,.471,45,74,119,29,15,13,28,56,178
1983,Kent Benson,C,28,DET,21,15,599,85,182,.467,0,1,.000,85,181,.470,.467,38,50,.760,53,102,155,49,14,17,35,61,208
1983,Larry Bird*,PF,26,BOS,79,79,2982,747,1481,.504,22,77,.286,725,1404,.516,.512,351,418,.840,193,677,870,458,148,71,240,197,1867
1983,Otis Birdsong,SG,27,NJN,62,54,1885,426,834,.511,2,6,.333,424,828,.512,.512,82,145,.566,53,97,150,239,85,16,114,155,936
1983,Rolando Blackman,SG,23,DAL,75,62,2349,513,1042,.492,3,15,.200,510,1027,.497,.494,297,381,.780,108,185,293,185,37,29,118,116,1326
1983,Charles Bradley,SG,23,BOS,51,5,532,69,176,.392,0,3,.000,69,173,.399,.392,46,90,.511,30,48,78,28,32,27,42,84,184
1983,Dudley Bradley,SG,25,CHI,58,11,683,82,159,.516,1,5,.200,81,154,.526,.519,36,45,.800,27,78,105,106,49,10,59,91,201
1983,Brad Branson,PF,24,IND,62,2,680,131,308,.425,0,1,.000,131,307,.427,.425,76,108,.704,73,100,173,46,27,26,45,81,338
1983,Mike Bratz,PG,27,CHI,15,0,140,14,42,.333,1,8,.125,13,34,.382,.345,10,13,.769,3,16,19,23,7,0,14,20,39
1983,Ron Brewer,SG,27,TOT,74,52,1964,344,807,.426,7,18,.389,337,789,.427,.431,142,170,.835,59,85,144,96,90,25,97,123,837
1983,Ron Brewer,SG,27,CLE,21,18,563,98,245,.400,0,3,.000,98,242,.405,.400,44,51,.863,9,28,37,27,20,6,25,27,240
1983,Ron Brewer,SG,27,GSW,53,34,1401,246,562,.438,7,15,.467,239,547,.437,.444,98,119,.824,50,57,107,69,70,19,72,96,597
1983,Junior Bridgeman,SF,29,MIL,70,5,1855,421,856,.492,1,13,.077,420,843,.498,.492,164,196,.837,44,202,246,207,40,9,122,155,1007
1983,Allan Bristow,SF,31,DAL,37,0,371,44,99,.444,6,13,.462,38,86,.442,.475,10,14,.714,24,35,59,70,6,1,31,46,104
1983,Jim Brogan,SG,24,SDC,58,0,466,91,213,.427,3,13,.231,88,200,.440,.434,34,43,.791,33,29,62,66,26,9,43,79,219
1983,Michael Brooks,SF,24,SDC,82,26,2457,402,830,.484,5,15,.333,397,815,.487,.487,193,277,.697,239,282,521,262,112,39,177,297,1002
1983,Fred Brown,PG,34,SEA,80,1,1432,371,714,.520,14,32,.438,357,682,.523,.529,58,72,.806,32,65,97,242,59,13,110,98,814
1983,Rickey Brown,C,24,TOT,76,7,1048,167,349,.479,0,3,.000,167,346,.483,.479,65,105,.619,91,175,266,25,13,26,82,172,399
1983,Rickey Brown,C,24,GSW,50,7,743,118,245,.482,0,2,.000,118,243,.486,.482,40,65,.615,56,122,178,16,8,21,60,126,276
1983,Rickey Brown,C,24,ATL,26,0,305,49,104,.471,0,1,.000,49,103,.476,.471,25,40,.625,35,53,88,9,5,5,22,46,123
1983,Joe Bryant,SF,28,HOU,81,56,2055,344,768,.448,8,36,.222,336,732,.459,.453,116,165,.703,88,189,277,186,82,30,177,258,812
1983,Quinn Buckner,SG,28,BOS,72,56,1565,248,561,.442,0,4,.000,248,557,.445,.442,74,117,.632,62,125,187,275,108,5,159,195,570
1983,Don Buse,PG,32,POR,41,1,643,72,182,.396,9,35,.257,63,147,.429,.420,41,46,.891,19,35,54,115,44,2,25,60,194
1983,Marty Byrnes,SF,26,IND,80,12,1436,157,374,.420,6,26,.231,151,348,.434,.428,71,95,.747,75,116,191,179,41,6,73,149,391
1983,Kenny Carr,PF,27,POR,82,26,2331,362,717,.505,2,6,.333,360,711,.506,.506,255,366,.697,182,407,589,116,62,42,185,306,981
1983,M.L. Carr,SF,32,BOS,77,0,883,135,315,.429,3,19,.158,132,296,.446,.433,60,81,.741,51,86,137,71,48,10,79,140,333
1983,Joe Barry Carroll,C,24,GSW,79,79,2988,785,1529,.513,0,3,.000,785,1526,.514,.513,337,469,.719,220,468,688,169,108,155,285,260,1907
1983,Butch Carter,SG,24,IND,81,28,1716,354,706,.501,17,51,.333,337,655,.515,.513,124,154,.805,62,88,150,194,78,13,118,207,849
1983,Bill Cartwright,C,25,NYK,82,82,2468,455,804,.566,0,0,,455,804,.566,.566,380,511,.744,185,405,590,136,41,127,204,315,1290
1983,Harvey Catchings,C,31,MIL,74,33,1554,90,197,.457,0,0,,90,197,.457,.457,62,92,.674,132,276,408,77,26,148,83,224,242
1983,Tom Chambers,PF,23,SDC,79,79,2665,519,1099,.472,0,8,.000,519,1091,.476,.472,353,488,.723,218,301,519,192,79,57,234,333,1391
1983,Maurice Cheeks*,PG,26,PHI,79,79,2465,404,745,.542,1,6,.167,403,739,.545,.543,181,240,.754,53,156,209,543,184,31,179,182,990
1983,Don Collins,SF,24,WSB,65,21,1575,332,635,.523,0,6,.000,332,629,.528,.523,101,136,.743,116,94,210,132,87,30,146,166,765
1983,Lester Conner,PG,23,GSW,75,10,1416,145,303,.479,0,4,.000,145,299,.485,.479,79,113,.699,69,152,221,253,116,7,99,141,369
1983,Darwin Cook,PG,24,NJN,82,47,2625,443,986,.449,8,38,.211,435,948,.459,.453,186,242,.769,73,167,240,448,194,48,238,213,1080
1983,Jeff Cook,PF,26,TOT,75,22,1333,148,304,.487,0,3,.000,148,301,.492,.487,79,104,.760,119,216,335,102,39,31,105,181,375
1983,Jeff Cook,PF,26,PHO,45,2,551,61,142,.430,0,2,.000,61,140,.436,.430,41,54,.759,44,85,129,58,12,13,56,89,163
1983,Jeff Cook,PF,26,CLE,30,20,782,87,162,.537,0,1,.000,87,161,.540,.537,38,50,.760,75,131,206,44,27,18,49,92,212
1983,Joe Cooper,C,25,TOT,20,4,333,37,72,.514,0,0,,37,72,.514,.514,16,29,.552,42,44,86,17,9,20,32,49,90
1983,Joe Cooper,C,25,LAL,2,0,11,1,4,.250,0,0,,1,4,.250,.250,0,0,,2,0,2,0,1,1,3,3,2
1983,Joe Cooper,C,25,WSB,5,0,47,5,9,.556,0,0,,5,9,.556,.556,5,9,.556,4,9,13,2,0,0,6,7,15
1983,Joe Cooper,C,25,SDC,13,4,275,31,59,.525,0,0,,31,59,.525,.525,11,20,.550,36,35,71,15,8,19,23,39,73
1983,Michael Cooper,SG,26,LAL,82,3,2148,266,497,.535,5,21,.238,261,476,.548,.540,102,130,.785,82,192,274,315,115,50,128,208,639
1983,Wayne Cooper,C,26,POR,80,60,2099,320,723,.443,0,5,.000,320,718,.446,.443,135,197,.685,214,397,611,116,27,136,162,318,775
1983,Dave Corzine,C,26,CHI,82,71,2496,457,920,.497,0,2,.000,457,918,.498,.497,232,322,.720,243,474,717,154,47,109,228,242,1146
1983,Dave Cowens*,PF,34,MIL,40,34,1014,136,306,.444,0,2,.000,136,304,.447,.444,52,63,.825,73,201,274,82,30,15,44,137,324
1983,Chubby Cox,SG,27,WSB,7,0,78,13,37,.351,0,2,.000,13,35,.371,.351,3,6,.500,7,3,10,6,0,1,9,16,29
1983,Charlie Criss,PG,34,MIL,66,0,922,169,375,.451,6,31,.194,163,344,.474,.459,68,76,.895,14,65,79,127,27,0,44,44,412
1983,Geoff Crompton,C,27,SAS,14,0,148,14,34,.412,0,0,,14,34,.412,.412,3,5,.600,18,30,48,7,3,5,5,25,31
1983,Pat Cummings,C,26,DAL,81,71,2317,433,878,.493,0,1,.000,433,877,.494,.493,148,196,.755,225,443,668,144,57,35,162,296,1014
1983,Terry Cummings,PF,21,SDC,70,69,2531,684,1309,.523,0,1,.000,684,1308,.523,.523,292,412,.709,303,441,744,177,129,62,204,294,1660
1983,Earl Cureton,C,25,PHI,73,3,987,108,258,.419,0,0,,108,258,.419,.419,33,67,.493,84,185,269,43,37,24,76,144,249
1983,Quintin Dailey,SG,22,CHI,76,32,2081,470,1008,.466,5,25,.200,465,983,.473,.469,206,282,.730,87,173,260,280,72,10,205,248,1151
1983,Adrian Dantley*,SF,27,UTA,22,22,887,233,402,.580,0,0,,233,402,.580,.580,210,248,.847,58,82,140,105,20,0,81,62,676
1983,Brad Davis,PG,27,DAL,79,78,2323,359,628,.572,11,43,.256,348,585,.595,.580,186,220,.845,34,164,198,565,80,11,143,176,915
1983,Charles Davis,SF,24,WSB,74,10,1161,251,534,.470,2,10,.200,249,524,.475,.472,56,89,.629,83,130,213,73,32,22,91,122,560
1983,Johnny Davis,SG,27,ATL,53,33,1465,258,567,.455,5,18,.278,253,549,.461,.459,164,206,.796,37,91,128,315,43,7,114,100,685
1983,Mike Davis,PF,26,NYK,8,0,28,4,10,.400,0,0,,4,10,.400,.400,6,10,.600,3,7,10,0,0,4,0,4,14
1983,Walter Davis,SG,28,PHO,80,79,2491,665,1289,.516,7,23,.304,658,1266,.520,.519,184,225,.818,63,134,197,397,117,12,188,186,1521
1983,Darryl Dawkins,C,26,NJN,81,81,2093,401,669,.599,0,0,,401,669,.599,.599,166,257,.646,127,293,420,114,67,152,281,379,968
1983,Kenny Dennard,PF,24,KCK,22,0,224,11,34,.324,0,0,,11,34,.324,.324,6,9,.667,20,32,52,6,16,1,5,27,28
1983,Coby Dietrick,C,34,SAS,8,0,34,1,5,.200,0,0,,1,5,.200,.200,0,2,.000,2,6,8,6,1,0,1,6,2
1983,James Donaldson,C,25,SEA,82,11,1789,289,496,.583,0,0,,289,496,.583,.583,150,218,.688,131,370,501,97,19,101,132,171,728
1983,John Douglas,SG,26,SDC,3,1,12,1,6,.167,1,2,.500,0,4,.000,.250,2,2,1.000,0,1,1,1,0,0,0,0,5
1983,Leon Douglas,C,28,KCK,5,0,46,2,3,.667,0,0,,2,3,.667,.667,0,2,.000,3,4,7,0,0,3,1,13,4
1983,John Drew,SF,28,UTA,44,33,1206,318,671,.474,0,5,.000,318,666,.477,.474,296,392,.755,98,137,235,97,35,7,135,152,932
1983,Larry Drew,PG,24,KCK,75,74,2690,599,1218,.492,2,16,.125,597,1202,.497,.493,310,378,.820,44,163,207,610,126,10,272,207,1510
1983,Terry Duerod,SG,26,GSW,5,0,49,9,19,.474,0,0,,9,19,.474,.474,0,0,,0,3,3,5,2,1,9,5,18
1983,Mike Dunleavy,PG,28,SAS,79,9,1619,213,510,.418,67,194,.345,146,316,.462,.483,120,154,.779,18,116,134,437,74,4,160,210,613
1983,T.R. Dunn,SG,27,DEN,82,80,2640,254,527,.482,0,1,.000,254,526,.483,.482,119,163,.730,231,384,615,189,147,25,113,218,627
1983,John Duren,PG,24,IND,82,24,1433,163,360,.453,0,13,.000,163,347,.470,.453,43,54,.796,38,69,107,200,66,5,96,203,369
1983,Mark Eaton,C,26,UTA,81,32,1528,146,353,.414,0,1,.000,146,352,.415,.414,59,90,.656,86,376,462,112,24,275,140,257,351
1983,Jerry Eaves,PG,23,UTA,82,7,1588,280,575,.487,1,8,.125,279,567,.492,.488,200,247,.810,34,88,122,210,51,3,152,116,761
1983,Keith Edmonson,SG,22,ATL,32,2,309,48,139,.345,0,2,.000,48,137,.350,.345,16,27,.593,20,19,39,22,11,6,20,41,112
1983,Franklin Edwards,PG,23,PHI,81,3,1266,228,483,.472,0,8,.000,228,475,.480,.472,86,113,.761,23,62,85,221,81,6,110,119,542
1983,James Edwards,C,27,TOT,31,9,667,128,263,.487,0,0,,128,263,.487,.487,69,108,.639,56,99,155,40,12,19,49,110,325
1983,James Edwards,C,27,CLE,15,8,382,73,150,.487,0,0,,73,150,.487,.487,38,61,.623,37,59,96,13,7,14,30,61,184
1983,James Edwards,C,27,PHO,16,1,285,55,113,.487,0,0,,55,113,.487,.487,31,47,.660,19,40,59,27,5,5,19,49,141
1983,Len Elmore,C,30,NJN,74,0,975,97,244,.398,0,1,.000,97,243,.399,.398,54,84,.643,81,157,238,39,44,38,83,125,248
1983,Chris Engler,C,23,GSW,54,1,369,38,94,.404,0,0,,38,94,.404,.404,5,16,.313,43,61,104,11,7,17,24,95,81
1983,Alex English*,SF,29,DEN,82,82,2988,959,1857,.516,2,12,.167,957,1845,.519,.517,406,490,.829,263,338,601,397,116,126,263,235,2326
1983,Julius Erving*,SF,32,PHI,72,72,2421,605,1170,.517,2,7,.286,603,1163,.518,.518,330,435,.759,173,318,491,263,112,131,196,202,1542
1983,Mike Evans,SG,27,DEN,42,5,695,115,243,.473,0,9,.000,115,234,.491,.473,33,41,.805,4,54,58,113,23,3,71,94,263
1983,Bruce Flowers,PF,25,CLE,53,5,699,110,206,.534,0,2,.000,110,204,.539,.534,41,53,.774,71,109,180,47,19,12,43,99,261
1983,Sleepy Floyd,PG,22,TOT,76,17,1248,226,527,.429,10,25,.400,216,502,.430,.438,150,180,.833,56,81,137,138,58,17,106,134,612
1983,Sleepy Floyd,PG,22,NJN,43,6,494,92,216,.426,4,14,.286,88,202,.436,.435,38,45,.844,16,26,42,67,19,9,40,56,226
1983,Sleepy Floyd,PG,22,GSW,33,11,754,134,311,.431,6,11,.545,128,300,.427,.441,112,135,.830,40,55,95,71,39,8,66,78,386
1983,Phil Ford,PG,26,TOT,77,63,1610,213,445,.479,1,9,.111,212,436,.486,.480,97,123,.789,18,85,103,290,52,3,134,190,524
1983,Phil Ford,PG,26,NJN,7,7,163,20,35,.571,0,1,.000,20,34,.588,.571,7,10,.700,0,7,7,38,6,0,21,22,47
1983,Phil Ford,PG,26,MIL,70,56,1447,193,410,.471,1,8,.125,192,402,.478,.472,90,113,.796,18,78,96,252,46,3,113,168,477
1983,World B. Free,SG,29,TOT,73,69,2638,649,1423,.456,15,45,.333,634,1378,.460,.461,430,583,.738,92,109,201,290,97,15,209,241,1743
1983,World B. Free,SG,29,GSW,19,18,700,164,364,.451,0,3,.000,164,361,.454,.451,106,149,.711,22,22,44,89,15,3,50,66,434
1983,World B. Free,SG,29,CLE,54,51,1938,485,1059,.458,15,42,.357,470,1017,.462,.465,324,434,.747,70,87,157,201,82,12,159,175,1309
1983,Bill Garnett,C,22,DAL,75,13,1411,170,319,.533,0,3,.000,170,316,.538,.533,129,174,.741,141,265,406,103,48,70,81,245,469
1983,Calvin Garrett,SF,26,HOU,4,0,34,4,11,.364,0,1,.000,4,10,.400,.364,2,2,1.000,3,4,7,3,0,0,3,4,10
1983,George Gervin*,SG,30,SAS,78,78,2830,757,1553,.487,12,33,.364,745,1520,.490,.491,517,606,.853,111,246,357,264,88,67,247,243,2043
1983,Artis Gilmore*,C,33,SAS,82,82,2797,556,888,.626,0,6,.000,556,882,.630,.626,367,496,.740,299,685,984,126,40,192,254,273,1479
1983,Mike Glenn,SG,27,ATL,73,4,1124,230,444,.518,0,1,.000,230,443,.519,.518,74,89,.831,16,74,90,125,30,9,52,132,534
1983,Mike Gminski,C,23,NJN,80,1,1255,213,426,.500,0,1,.000,213,425,.501,.500,175,225,.778,154,228,382,61,35,116,126,118,601
1983,Glen Gondrezick,PF,27,DEN,76,2,1130,134,294,.456,0,3,.000,134,291,.460,.456,82,114,.719,108,193,301,100,80,9,49,161,350
1983,Rickey Green,PG,28,UTA,78,78,2783,464,942,.493,2,13,.154,462,929,.497,.494,185,232,.797,62,161,223,697,220,4,222,154,1115
1983,Dave Greenwood,PF,25,CHI,79,61,2355,312,686,.455,0,4,.000,312,682,.457,.455,165,233,.708,217,548,765,151,54,90,154,261,789
1983,John Greig,SF,21,SEA,9,0,26,7,13,.538,0,0,,7,13,.538,.538,5,6,.833,2,4,6,0,0,1,2,4,19
1983,Kevin Grevey,SF,29,WSB,41,11,756,114,294,.388,15,38,.395,99,256,.387,.413,54,69,.783,18,31,49,49,18,7,27,61,297
1983,Paul Griffin,PF,29,SAS,53,0,956,60,116,.517,0,0,,60,116,.517,.517,53,76,.697,77,139,216,86,33,25,68,153,173
1983,Darrell Griffith,SG,24,UTA,77,76,2787,752,1554,.484,38,132,.288,714,1422,.502,.496,167,246,.679,100,204,304,270,138,33,252,184,1709
1983,Bob Gross,SF,29,SDC,27,3,373,35,82,.427,1,3,.333,34,79,.430,.433,12,19,.632,32,34,66,34,22,7,24,69,83
1983,Ernie Grunfeld,SF,27,NYK,77,0,1422,167,377,.443,0,4,.000,167,373,.448,.443,81,98,.827,42,121,163,136,40,10,84,172,415
1983,Bill Hanzlik,SF,25,DEN,82,8,1547,187,437,.428,1,7,.143,186,430,.433,.429,125,160,.781,80,156,236,268,75,15,144,220,500
1983,Joe Hassett,SG,27,GSW,6,2,139,19,44,.432,1,9,.111,18,35,.514,.443,0,0,,3,8,11,21,2,0,9,14,39
1983,Scott Hastings,C-PF,22,TOT,31,0,140,13,38,.342,0,3,.000,13,35,.371,.342,11,20,.550,15,26,41,3,6,1,9,34,37
1983,Scott Hastings,C,22,NYK,21,0,98,8,22,.364,0,1,.000,8,21,.381,.364,7,14,.500,10,21,31,1,5,0,6,31,23
1983,Scott Hastings,PF,22,ATL,10,0,42,5,16,.313,0,2,.000,5,14,.357,.313,4,6,.667,5,5,10,2,1,1,3,3,14
1983,Steve Hawes,PF,32,TOT,77,4,1416,163,390,.418,5,21,.238,158,369,.428,.424,69,94,.734,81,280,361,95,38,14,107,189,400
1983,Steve Hawes,PF,32,ATL,46,3,860,91,244,.373,2,14,.143,89,230,.387,.377,46,62,.742,53,175,228,59,29,8,73,110,230
1983,Steve Hawes,PF,32,SEA,31,1,556,72,146,.493,3,7,.429,69,139,.496,.503,23,32,.719,28,105,133,36,9,6,34,79,170
1983,Elvin Hayes*,PF,37,HOU,81,43,2302,424,890,.476,2,4,.500,422,886,.476,.478,196,287,.683,199,417,616,158,50,81,200,232,1046
1983,Steve Hayes,C,27,CLE,65,3,1058,104,217,.479,0,1,.000,104,216,.481,.479,29,51,.569,102,134,236,36,17,41,49,215,237
1983,Spencer Haywood*,PF,33,WSB,38,25,775,125,312,.401,0,1,.000,125,311,.402,.401,63,87,.724,77,106,183,30,12,27,67,94,313
1983,Gerald Henderson,PG,27,BOS,82,9,1551,286,618,.463,3,16,.188,283,602,.470,.465,96,133,.722,57,67,124,195,95,3,128,190,671
1983,Tom Henderson,SG,31,HOU,51,2,789,107,263,.407,0,2,.000,107,261,.410,.407,45,57,.789,18,51,69,138,37,2,50,57,259
1983,Rod Higgins,SF,23,CHI,82,42,2196,313,698,.448,13,41,.317,300,657,.457,.458,209,264,.792,159,207,366,175,66,65,127,248,848
1983,Johnny High,SG,25,PHO,82,2,1155,100,217,.461,1,5,.200,99,212,.467,.463,63,136,.463,45,105,150,153,85,34,106,205,264
1983,Armond Hill,PG,29,MIL,14,3,169,14,26,.538,0,0,,14,26,.538,.538,18,22,.818,5,15,20,27,9,0,13,20,46
1983,Craig Hodges,SG,22,SDC,76,48,2022,318,704,.452,20,90,.222,298,614,.485,.466,94,130,.723,53,69,122,275,82,4,161,192,750
1983,Lionel Hollins,PG,29,SDC,56,54,1844,313,717,.437,3,21,.143,310,696,.445,.439,129,179,.721,30,98,128,373,111,14,198,155,758
1983,Phil Hubbard,SF,26,CLE,82,38,1953,288,597,.482,0,2,.000,288,595,.484,.482,204,296,.689,222,249,471,89,87,8,158,271,780
1983,Geoff Huston,PG,25,CLE,80,79,2716,401,832,.482,4,12,.333,397,820,.484,.484,168,245,.686,41,118,159,487,74,4,195,215,974
1983,Marc Iavaroni,PF,26,PHI,80,77,1612,163,353,.462,0,2,.000,163,351,.464,.462,78,113,.690,117,212,329,83,32,44,133,238,404
1983,Dan Issel*,C,34,DEN,80,80,2431,661,1296,.510,4,19,.211,657,1277,.514,.512,400,479,.835,151,445,596,223,83,43,174,227,1726
1983,Tracy Jackson,SG,23,CHI,78,3,1309,199,426,.467,2,13,.154,197,413,.477,.469,92,126,.730,87,92,179,105,64,11,83,132,492
1983,Clay Johnson,SG,26,LAL,48,0,447,53,135,.393,0,2,.000,53,133,.398,.393,38,48,.792,40,29,69,24,22,4,25,62,144
1983,Clemon Johnson,C,26,TOT,83,11,1914,299,581,.515,0,1,.000,299,580,.516,.515,111,180,.617,190,334,524,139,67,92,124,221,709
1983,Clemon Johnson,C,26,IND,51,7,1216,208,399,.521,0,1,.000,208,398,.523,.521,77,122,.631,115,204,319,115,51,63,88,137,493
1983,Clemon Johnson,C,26,PHI,32,4,698,91,182,.500,0,0,,91,182,.500,.500,34,58,.586,75,130,205,24,16,29,36,84,216
1983,Dennis Johnson*,PG,28,PHO,77,74,2551,398,861,.462,5,31,.161,393,830,.473,.465,292,369,.791,92,243,335,388,97,39,204,204,1093
1983,Eddie Johnson,SG,27,ATL,61,57,1813,389,858,.453,14,41,.341,375,817,.459,.462,186,237,.785,26,98,124,318,61,6,156,138,978
1983,Eddie Johnson,SF,23,KCK,82,82,2933,677,1370,.494,20,71,.282,657,1299,.506,.501,247,317,.779,191,310,501,216,70,20,181,259,1621
1983,Frank Johnson,PG,24,WSB,68,65,2324,321,786,.408,14,61,.230,307,725,.423,.417,196,261,.751,46,132,178,549,110,6,238,170,852
1983,George Johnson,C,34,ATL,37,0,461,25,57,.439,0,0,,25,57,.439,.439,14,19,.737,44,73,117,17,10,59,19,69,64
1983,George Johnson,SF,26,IND,82,64,2297,409,858,.477,7,38,.184,402,820,.490,.481,126,172,.733,176,369,545,220,77,53,242,279,951
1983,Magic Johnson*,SG,23,LAL,79,79,2907,511,933,.548,0,21,.000,511,912,.560,.548,304,380,.800,214,469,683,829,176,47,301,200,1326
1983,Marques Johnson,SF,26,MIL,80,80,2853,723,1420,.509,4,20,.200,719,1400,.514,.511,264,359,.735,196,366,562,363,100,56,196,211,1714
1983,Mickey Johnson,PF,30,TOT,78,16,2053,391,921,.425,3,36,.083,388,885,.438,.426,312,380,.821,163,331,494,255,82,46,238,288,1097
1983,Mickey Johnson,PF,30,MIL,6,0,153,30,66,.455,0,2,.000,30,64,.469,.455,7,9,.778,9,16,25,11,1,2,12,22,67
1983,Mickey Johnson,PF,30,NJN,42,7,1001,199,496,.401,2,17,.118,197,479,.411,.403,164,201,.816,66,158,224,144,56,21,121,135,564
1983,Mickey Johnson,PF,30,GSW,30,9,899,162,359,.451,1,17,.059,161,342,.471,.453,141,170,.829,88,157,245,100,25,23,105,131,466
1983,Reggie Johnson,SF,25,TOT,79,8,1541,247,509,.485,1,4,.250,246,505,.487,.486,95,130,.731,107,184,291,71,26,43,104,232,590
1983,Reggie Johnson,SF,25,KCK,50,0,992,178,355,.501,1,4,.250,177,351,.504,.503,73,100,.730,75,126,201,48,18,26,69,150,430
1983,Reggie Johnson,SF,25,PHI,29,8,549,69,154,.448,0,0,,69,154,.448,.448,22,30,.733,32,58,90,23,8,17,35,82,160
1983,Steve Johnson,C,25,KCK,79,21,1544,371,595,.624,0,0,,371,595,.624,.624,186,324,.574,140,258,398,95,40,83,180,323,928
1983,Vinnie Johnson,SG,26,DET,82,51,2511,520,1013,.513,11,40,.275,509,973,.523,.519,245,315,.778,167,186,353,301,93,49,152,263,1296
1983,Jim Johnstone,PF-C,22,TOT,23,0,191,11,30,.367,0,0,,11,30,.367,.367,9,20,.450,15,31,46,11,3,7,15,33,31
1983,Jim Johnstone,C,22,SAS,7,0,54,2,10,.200,0,0,,2,10,.200,.200,3,5,.600,4,12,16,1,1,1,4,9,7
1983,Jim Johnstone,PF,22,DET,16,0,137,9,20,.450,0,0,,9,20,.450,.450,6,15,.400,11,19,30,10,2,6,11,24,24
1983,Bobby Jones*,PF,31,PHI,74,0,1749,250,460,.543,0,1,.000,250,459,.545,.543,165,208,.793,102,242,344,142,85,91,109,199,665
1983,Caldwell Jones,C,32,HOU,82,82,2440,307,677,.453,0,2,.000,307,675,.455,.453,162,206,.786,222,446,668,138,46,131,171,278,776
1983,Dwight Jones,PF,30,TOT,81,2,1164,148,325,.455,0,1,.000,148,324,.457,.455,79,123,.642,84,225,309,62,31,23,101,172,375
1983,Dwight Jones,PF,30,CHI,49,2,673,86,193,.446,0,0,,86,193,.446,.446,47,75,.627,56,139,195,40,18,14,66,90,219
1983,Dwight Jones,PF,30,LAL,32,0,491,62,132,.470,0,1,.000,62,131,.473,.470,32,48,.667,28,86,114,22,13,9,35,82,156
1983,Edgar Jones,PF,26,TOT,77,28,1658,237,479,.495,2,9,.222,235,470,.500,.497,201,286,.703,136,312,448,89,42,108,146,267,677
1983,Edgar Jones,PF,26,DET,49,25,1036,145,294,.493,2,6,.333,143,288,.497,.497,117,172,.680,80,191,271,69,28,77,103,160,409
1983,Edgar Jones,PF,26,SAS,28,3,622,92,185,.497,0,3,.000,92,182,.505,.497,84,114,.737,56,121,177,20,14,31,43,107,268
1983,Hutch Jones,SF,23,SDC,9,0,85,17,37,.459,0,0,,17,37,.459,.459,6,6,1.000,10,7,17,4,3,0,6,14,40
1983,Major Jones,PF,29,HOU,60,4,878,142,311,.457,0,2,.000,142,309,.460,.457,56,102,.549,114,149,263,39,22,22,83,104,340
1983,Eddie Jordan,PG,28,LAL,35,0,333,40,132,.303,3,16,.188,37,116,.319,.314,11,17,.647,8,18,26,80,31,1,54,52,94
1983,Jeff Judkins,SF,26,POR,34,0,309,39,88,.443,2,8,.250,37,80,.463,.455,25,30,.833,18,25,43,17,15,2,17,39,105
1983,Rich Kelley,C,29,TOT,70,23,1345,130,293,.444,0,0,,130,293,.444,.444,142,175,.811,131,273,404,138,54,39,118,221,402
1983,Rich Kelley,C,29,DEN,38,0,565,59,141,.418,0,0,,59,141,.418,.418,55,70,.786,61,111,172,59,21,18,53,115,173
1983,Rich Kelley,C,29,UTA,32,23,780,71,152,.467,0,0,,71,152,.467,.467,87,105,.829,70,162,232,79,33,21,65,106,229
1983,Clark Kellogg,PF,21,IND,81,81,2761,680,1420,.479,4,18,.222,676,1402,.482,.480,261,352,.741,340,520,860,223,141,43,217,298,1625
1983,Greg Kelser,SF,25,SEA,80,9,1507,247,450,.549,0,3,.000,247,447,.553,.549,173,257,.673,158,245,403,97,52,35,149,243,667
1983,Larry Kenon,PF,30,TOT,48,7,770,119,257,.463,0,1,.000,119,256,.465,.463,42,57,.737,66,81,147,39,23,9,47,64,280
1983,Larry Kenon,PF,30,CHI,5,0,25,2,6,.333,0,0,,2,6,.333,.333,0,0,,1,3,4,0,1,0,2,2,4
1983,Larry Kenon,PF,30,GSW,11,0,121,17,39,.436,0,0,,17,39,.436,.436,7,11,.636,13,13,26,5,1,0,6,13,41
1983,Larry Kenon,PF,30,CLE,32,7,624,100,212,.472,0,1,.000,100,211,.474,.472,35,46,.761,52,65,117,34,21,9,39,49,235
1983,Albert King,SF,23,NJN,79,75,2447,582,1226,.475,6,23,.261,576,1203,.479,.477,176,227,.775,157,299,456,291,95,41,245,278,1346
1983,Bernard King*,SF,26,NYK,68,68,2207,603,1142,.528,0,6,.000,603,1136,.531,.528,280,388,.722,99,227,326,195,90,13,197,233,1486
1983,Reggie King,SF,25,KCK,58,5,995,104,225,.462,0,0,,104,225,.462,.462,73,96,.760,91,149,240,58,28,11,65,94,281
1983,Billy Knight,SG,30,IND,80,54,2262,512,984,.520,3,19,.158,509,965,.527,.522,343,408,.841,152,172,324,192,66,8,193,143,1370
1983,Joe Kopicki,PF,22,WSB,17,1,201,23,51,.451,0,1,.000,23,50,.460,.451,21,25,.840,18,44,62,9,9,2,8,21,67
1983,Joel Kramer,C,27,PHO,54,4,458,44,104,.423,0,1,.000,44,103,.427,.423,14,16,.875,41,47,88,37,15,6,22,63,102
1983,Sam Lacey,C,34,CLE,60,33,1232,111,264,.420,2,9,.222,109,255,.427,.424,29,37,.784,62,169,231,118,29,25,98,209,253
1983,Bill Laimbeer,C,25,DET,82,82,2871,436,877,.497,2,13,.154,434,864,.502,.498,245,310,.790,282,711,993,263,51,118,176,320,1119
1983,Jeff Lamp,SF,23,POR,59,1,690,107,252,.425,1,6,.167,106,246,.431,.427,42,52,.808,25,51,76,58,20,3,38,67,257
1983,Mark Landsberger,PF,27,LAL,39,4,356,43,102,.422,0,0,,43,102,.422,.422,12,25,.480,55,73,128,12,8,4,20,48,98
1983,Bob Lanier*,C,34,MIL,39,35,978,163,332,.491,0,1,.000,163,331,.492,.491,91,133,.684,58,142,200,105,34,24,82,125,417
1983,Allen Leavell,PG,25,HOU,79,76,2602,439,1059,.415,42,175,.240,397,884,.449,.434,247,297,.832,64,131,195,530,165,14,198,215,1167
1983,Ronnie Lester,PG,24,CHI,65,38,1437,202,446,.453,0,5,.000,202,441,.458,.453,124,171,.725,46,126,172,332,51,6,134,121,528
1983,Fat Lever,PG,22,POR,81,45,2020,256,594,.431,5,15,.333,251,579,.434,.435,116,159,.730,85,140,225,426,153,15,137,179,633
1983,Cliff Levingston,PF,22,DET,62,5,879,131,270,.485,0,1,.000,131,269,.487,.485,84,147,.571,104,128,232,52,23,36,73,125,346
1983,Steve Lingenfelter,PF,24,WSB,7,0,53,4,6,.667,0,0,,4,6,.667,.667,0,4,.000,1,11,12,4,1,3,5,16,8
1983,Alton Lister,PF,24,MIL,80,37,1885,272,514,.529,0,0,,272,514,.529,.529,130,242,.537,168,400,568,111,50,177,186,328,674
1983,Lewis Lloyd,SG,23,GSW,73,24,1350,293,566,.518,1,4,.250,292,562,.520,.519,100,139,.719,77,183,260,130,61,31,118,109,687
1983,Scott Lloyd,C,30,DAL,15,0,206,19,50,.380,0,1,.000,19,49,.388,.380,11,17,.647,19,27,46,21,6,6,6,24,49
1983,Kevin Loder,SF,23,KCK,66,13,818,138,300,.460,5,9,.556,133,291,.457,.468,53,80,.663,37,88,125,72,29,8,64,98,334
1983,John Long,SG,26,DET,70,30,1485,312,692,.451,2,7,.286,310,685,.453,.452,111,146,.760,56,124,180,105,44,12,144,130,737
1983,John Lucas,PG,29,WSB,35,0,386,62,131,.473,0,5,.000,62,126,.492,.473,21,42,.500,8,21,29,102,25,1,47,18,145
1983,Maurice Lucas,PF,30,PHO,77,71,2586,495,1045,.474,1,3,.333,494,1042,.474,.474,278,356,.781,201,598,799,219,56,43,221,274,1269
1983,Rudy Macklin,SF,24,ATL,73,20,1171,170,360,.472,0,4,.000,170,356,.478,.472,101,131,.771,85,105,190,71,41,10,89,189,441
1983,Kyle Macy,PG,25,PHO,82,9,1836,328,634,.517,23,76,.303,305,558,.547,.535,129,148,.872,41,124,165,278,64,8,90,130,808
1983,Dave Magley,SF,23,CLE,14,0,56,4,16,.250,0,1,.000,4,15,.267,.250,4,8,.500,2,8,10,2,2,0,2,5,12
1983,Rick Mahorn,PF,24,WSB,82,82,3023,376,768,.490,0,3,.000,376,765,.492,.490,146,254,.575,171,608,779,115,86,148,170,335,898
1983,Moses Malone*,C,27,PHI,78,78,2922,654,1305,.501,0,1,.000,654,1304,.502,.501,600,788,.761,445,749,1194,101,89,157,264,206,1908
1983,Wes Matthews,PG,23,ATL,64,0,1187,171,424,.403,14,48,.292,157,376,.418,.420,86,112,.768,25,66,91,249,60,8,123,129,442
1983,Cedric Maxwell,SF,27,BOS,79,71,2252,331,663,.499,0,1,.000,331,662,.500,.499,280,345,.812,185,237,422,186,65,39,165,202,942
1983,Scott May,SF,28,DET,9,1,155,21,50,.420,0,0,,21,50,.420,.420,17,21,.810,10,16,26,12,5,2,13,24,59
1983,Bob McAdoo*,C,31,LAL,47,1,1019,292,562,.520,0,1,.000,292,561,.520,.520,119,163,.730,76,171,247,39,40,40,68,153,703
1983,Hank McDowell,PF,23,TOT,56,0,505,58,126,.460,0,2,.000,58,124,.468,.460,47,61,.770,54,65,119,24,8,11,40,84,163
1983,Hank McDowell,PF,23,GSW,14,0,130,13,29,.448,0,0,,13,29,.448,.448,14,18,.778,15,15,30,4,2,4,8,26,40
1983,Hank McDowell,PF,23,POR,42,0,375,45,97,.464,0,2,.000,45,95,.474,.464,33,43,.767,39,50,89,20,6,7,32,58,123
1983,Mike McGee,SF,23,LAL,39,7,381,69,163,.423,1,7,.143,68,156,.436,.426,17,23,.739,33,20,53,26,11,5,27,50,156
1983,Kevin McHale*,PF,25,BOS,82,13,2345,483,893,.541,0,1,.000,483,892,.541,.541,193,269,.717,215,338,553,104,34,192,159,241,1159
1983,Billy McKinney,PG,27,DEN,68,38,1559,266,546,.487,0,7,.000,266,539,.494,.487,136,167,.814,21,100,121,288,39,5,101,142,668
1983,Tom McMillen,C,30,ATL,61,4,1364,198,424,.467,0,1,.000,198,423,.468,.467,108,133,.812,57,160,217,76,17,24,80,143,504
1983,Mark McNamara,C,23,PHI,36,2,182,29,64,.453,0,0,,29,64,.453,.453,20,45,.444,34,42,76,7,3,3,36,42,78
1983,Joe Meriweather,C,29,KCK,78,74,1706,258,453,.570,0,0,,258,453,.570,.570,102,163,.626,150,274,424,64,47,86,118,285,618
1983,Mike Mitchell,SF,27,SAS,80,79,2803,686,1342,.511,0,3,.000,686,1339,.512,.511,219,289,.758,188,349,537,98,57,52,126,248,1591
1983,Steve Mix,SF,35,TOT,58,20,809,137,283,.484,1,4,.250,136,279,.487,.486,75,88,.852,38,99,137,70,33,3,45,71,350
1983,Steve Mix,SF,35,MIL,57,20,792,133,273,.487,1,4,.250,132,269,.491,.489,74,87,.851,37,99,136,68,33,3,45,70,341
1983,Steve Mix,SF,35,LAL,1,0,17,4,10,.400,0,0,,4,10,.400,.400,1,1,1.000,1,0,1,2,0,0,0,1,9
1983,Paul Mokeski,C,26,TOT,73,19,1128,119,260,.458,0,1,.000,119,259,.459,.458,50,68,.735,76,184,260,49,21,44,67,223,288
1983,Paul Mokeski,C,26,CLE,23,18,539,55,121,.455,0,0,,55,121,.455,.455,16,26,.615,47,91,138,26,12,23,27,85,126
1983,Paul Mokeski,C,26,MIL,50,1,589,64,139,.460,0,1,.000,64,138,.464,.460,34,42,.810,29,93,122,23,9,21,40,138,162
1983,Sidney Moncrief*,SG,25,MIL,76,76,2710,606,1156,.524,1,10,.100,605,1146,.528,.525,499,604,.826,192,245,437,300,113,23,197,180,1712
1983,Johnny Moore,PG,24,SAS,77,73,2552,394,841,.468,5,22,.227,389,819,.475,.471,148,199,.744,65,212,277,753,194,32,226,247,941
1983,Lowes Moore,PG,25,SDC,37,3,642,81,190,.426,6,23,.261,75,167,.449,.442,42,56,.750,15,40,55,73,22,1,46,72,210
1983,Guy Morgan,SG,22,IND,8,0,46,7,24,.292,0,0,,7,24,.292,.292,1,4,.250,6,11,17,7,2,0,2,7,15
1983,Calvin Murphy*,PG,34,HOU,64,0,1423,337,754,.447,4,14,.286,333,740,.450,.450,138,150,.920,34,40,74,158,59,4,89,163,816
1983,Larry Nance,PF,23,PHO,82,82,2914,588,1069,.550,1,3,.333,587,1066,.551,.551,193,287,.672,239,471,710,197,99,217,190,254,1370
1983,Swen Nater,C,33,SDC,7,0,51,6,20,.300,0,0,,6,20,.300,.300,4,4,1.000,2,11,13,1,1,0,3,1,16
1983,Calvin Natt,SF,26,POR,80,80,2879,644,1187,.543,3,20,.150,641,1167,.549,.544,339,428,.792,214,385,599,171,63,29,203,184,1630
1983,Kenny Natt,SG,24,UTA,22,0,210,38,73,.521,0,2,.000,38,71,.535,.521,9,14,.643,6,16,22,28,5,0,22,36,85
1983,Ed Nealy,PF,22,KCK,82,61,1643,147,247,.595,0,0,,147,247,.595,.595,70,114,.614,170,315,485,62,68,12,51,247,364
1983,Chuck Nevitt,C,23,HOU,6,0,64,11,15,.733,0,0,,11,15,.733,.733,1,4,.250,6,11,17,0,1,12,7,14,23
1983,Carl Nicks,SG,24,CLE,9,2,148,26,59,.441,0,1,.000,26,58,.448,.441,11,17,.647,8,18,26,11,6,0,11,17,63
1983,Kurt Nimphius,C,24,DAL,81,12,1515,174,355,.490,1,1,1.000,173,354,.489,.492,77,140,.550,157,247,404,115,24,111,66,287,426
1983,Norm Nixon,PG,27,LAL,79,79,2711,533,1123,.475,0,13,.000,533,1110,.480,.475,125,168,.744,61,144,205,566,104,4,237,176,1191
1983,Audie Norris,C,22,POR,30,0,311,26,63,.413,0,0,,26,63,.413,.413,14,30,.467,25,44,69,24,13,2,33,61,66
1983,Mike O'Koren,SF,24,NJN,46,14,803,136,259,.525,2,9,.222,134,250,.536,.529,34,48,.708,42,72,114,82,42,11,62,67,308
1983,Mark Olberding,PF,26,CHI,80,31,1817,251,522,.481,2,12,.167,249,510,.488,.483,194,248,.782,108,250,358,131,50,9,152,246,698
1983,Jawann Oldham,C,25,CHI,16,0,171,31,58,.534,0,0,,31,58,.534,.534,12,22,.545,18,29,47,5,5,13,13,30,74
1983,Louis Orr,SF,24,NYK,82,14,1666,274,593,.462,0,2,.000,274,591,.464,.462,140,175,.800,94,134,228,94,64,24,93,134,688
1983,Tom Owens,C,33,DET,49,4,725,81,192,.422,0,0,,81,192,.422,.422,45,66,.682,66,120,186,44,12,14,48,115,207
1983,Robert Parish*,C,29,BOS,78,76,2459,619,1125,.550,0,1,.000,619,1124,.551,.550,271,388,.698,260,567,827,141,79,148,185,222,1509
1983,Billy Paultz,C,34,TOT,64,0,820,101,227,.445,0,0,,101,227,.445,.445,27,59,.458,64,136,200,61,17,18,47,109,229
1983,Billy Paultz,C,34,HOU,57,0,695,89,200,.445,0,0,,89,200,.445,.445,26,57,.456,54,113,167,57,12,12,41,95,204
1983,Billy Paultz,C,34,SAS,7,0,125,12,27,.444,0,0,,12,27,.444,.444,1,2,.500,10,23,33,4,5,6,6,14,25
1983,Jim Paxson,SG,25,POR,81,81,2740,682,1323,.515,4,25,.160,678,1298,.522,.517,388,478,.812,68,106,174,231,140,17,156,160,1756
1983,Sam Pellom,PF,31,TOT,6,0,29,6,16,.375,0,0,,6,16,.375,.375,0,0,,2,6,8,1,0,0,2,3,12
1983,Sam Pellom,PF,31,ATL,2,0,9,2,6,.333,0,0,,2,6,.333,.333,0,0,,0,0,0,1,0,0,0,0,4
1983,Sam Pellom,PF,31,MIL,4,0,20,4,10,.400,0,0,,4,10,.400,.400,0,0,,2,6,8,0,0,0,2,3,8
1983,Roger Phegley,SG,26,SAS,62,4,599,120,267,.449,3,14,.214,117,253,.462,.455,43,56,.768,39,45,84,60,30,8,49,92,286
1983,Eddie Phillips,SF,21,NJN,48,0,416,56,138,.406,0,2,.000,56,136,.412,.406,40,59,.678,27,50,77,29,14,8,50,58,152
1983,Ricky Pierce,SG,23,DET,39,1,265,33,88,.375,1,7,.143,32,81,.395,.381,18,32,.563,15,20,35,14,8,4,18,42,85
1983,Charles Pittman,PF,24,PHO,28,0,170,19,40,.475,0,1,.000,19,39,.487,.475,25,37,.676,13,18,31,7,2,7,22,41,63
1983,Ben Poquette,PF,27,UTA,75,50,2331,329,697,.472,1,5,.200,328,692,.474,.473,166,221,.751,155,366,521,168,64,116,100,264,825
1983,Kevin Porter,PG,32,WSB,11,0,210,21,40,.525,0,0,,21,40,.525,.525,5,6,.833,2,3,5,46,10,0,21,30,47
1983,Paul Pressey,SG,24,MIL,79,18,1528,213,466,.457,1,9,.111,212,457,.464,.458,105,176,.597,83,198,281,207,99,47,162,174,532
1983,Mark Radford,SG,23,SEA,54,2,439,84,172,.488,4,18,.222,80,154,.519,.500,30,73,.411,12,35,47,104,34,4,74,78,202
1983,Ed Rains,SF,26,SAS,34,1,292,33,83,.398,0,1,.000,33,82,.402,.398,29,43,.674,25,19,44,22,10,1,25,35,95
1983,Kurt Rambis,PF,24,LAL,78,77,1806,235,413,.569,0,2,.000,235,411,.572,.569,114,166,.687,164,367,531,90,105,63,145,233,584
1983,Kelvin Ransey,PG,24,DAL,76,4,1607,343,746,.460,2,16,.125,341,730,.467,.461,152,199,.764,44,103,147,280,58,4,129,109,840
1983,James Ray,PF,25,DEN,45,3,433,70,153,.458,0,1,.000,70,152,.461,.458,33,51,.647,37,89,126,39,24,19,50,83,173
1983,Clint Richardson,SG,26,PHI,77,1,1755,259,559,.463,0,6,.000,259,553,.468,.463,71,111,.640,98,149,247,168,71,18,99,164,589
1983,Micheal Ray Richardson,PG,27,TOT,64,51,2076,346,815,.425,8,51,.157,338,764,.442,.429,106,163,.650,113,182,295,432,182,24,244,240,806
1983,Micheal Ray Richardson,PG,27,GSW,33,25,1074,176,427,.412,4,31,.129,172,396,.434,.417,55,87,.632,45,100,145,245,101,9,137,124,411
1983,Micheal Ray Richardson,PG,27,NJN,31,26,1002,170,388,.438,4,20,.200,166,368,.451,.443,51,76,.671,68,82,150,187,81,15,107,116,395
1983,Rick Robey,C,27,BOS,59,6,855,100,214,.467,0,0,,100,214,.467,.467,45,78,.577,79,140,219,65,13,8,72,131,245
1983,Cliff Robinson,PF,22,CLE,77,75,2601,587,1230,.477,0,5,.000,587,1225,.479,.477,213,301,.708,190,666,856,145,61,58,224,272,1387
1983,Oliver Robinson,SG,22,SAS,35,0,147,35,97,.361,1,11,.091,34,86,.395,.366,30,45,.667,6,11,17,21,4,2,13,18,101
1983,Truck Robinson,PF,31,NYK,81,76,2426,326,706,.462,0,0,,326,706,.462,.462,118,201,.587,199,458,657,145,57,24,190,241,770
1983,Dave Robisch,C,33,DEN,61,0,711,96,251,.382,0,1,.000,96,250,.384,.382,92,118,.780,34,117,151,53,10,9,45,61,284
1983,Tree Rollins,C,27,ATL,80,80,2472,261,512,.510,0,1,.000,261,511,.511,.510,98,135,.726,210,533,743,75,49,343,95,294,620
1983,Lorenzo Romar,PG,24,GSW,82,64,2130,266,572,.465,10,33,.303,256,539,.475,.474,78,105,.743,23,115,138,455,98,5,141,142,620
1983,Dan Roundfield,PF,29,ATL,77,76,2811,561,1193,.470,5,27,.185,556,1166,.477,.472,337,450,.749,259,621,880,225,60,115,245,239,1464
1983,Jeff Ruland,C,24,WSB,79,47,2862,580,1051,.552,1,3,.333,579,1048,.552,.552,375,544,.689,293,578,871,234,74,77,297,312,1536
1983,Walker Russell,PG,22,DET,68,1,757,67,184,.364,2,18,.111,65,166,.392,.370,47,58,.810,19,54,73,131,16,1,92,71,183
1983,Mike Sanders,SF,22,SAS,26,0,393,76,157,.484,0,2,.000,76,155,.490,.484,31,43,.721,31,63,94,19,18,6,28,57,183
1983,Danny Schayes,C,23,TOT,82,50,2284,342,749,.457,0,1,.000,342,748,.457,.457,228,295,.773,200,435,635,205,54,98,253,325,912
1983,Danny Schayes,C,23,UTA,50,50,1638,231,514,.449,0,1,.000,231,513,.450,.449,157,195,.805,137,312,449,165,39,68,195,216,619
1983,Danny Schayes,C,23,DEN,32,0,646,111,235,.472,0,0,,111,235,.472,.472,71,100,.710,63,123,186,40,15,30,58,109,293
1983,Russ Schoene,PF,22,TOT,77,7,1222,207,435,.476,1,4,.250,206,431,.478,.477,61,83,.735,96,159,255,59,25,23,81,192,476
1983,Russ Schoene,PF,22,PHI,46,2,702,106,207,.512,0,1,.000,106,206,.515,.512,21,28,.750,52,102,154,32,13,9,46,118,233
1983,Russ Schoene,PF,22,IND,31,5,520,101,228,.443,1,3,.333,100,225,.444,.445,40,55,.727,44,57,101,27,12,14,35,74,243
1983,Alvin Scott,SF,27,PHO,81,9,1139,124,259,.479,0,2,.000,124,257,.482,.479,81,110,.736,60,164,224,97,48,31,64,133,329
1983,Lonnie Shelton,PF,27,SEA,82,79,2572,437,915,.478,1,6,.167,436,909,.480,.478,141,187,.754,158,337,495,237,75,72,172,310,1016
1983,Ed Sherod,PG,23,NYK,64,37,1624,171,421,.406,1,13,.077,170,408,.417,.407,52,80,.650,43,106,149,311,96,14,104,112,395
1983,Purvis Short,SF,25,GSW,67,57,2397,589,1209,.487,4,15,.267,585,1194,.490,.489,255,308,.828,145,209,354,228,94,14,194,242,1437
1983,Jerry Sichting,PG,26,IND,78,58,2435,316,661,.478,3,18,.167,313,643,.487,.480,92,107,.860,33,122,155,433,104,2,138,185,727
1983,Jack Sikma*,C,27,SEA,75,71,2564,484,1043,.464,0,8,.000,484,1035,.468,.464,400,478,.837,213,645,858,233,87,65,190,263,1368
1983,Jose Slaughter,SG,22,IND,63,1,515,89,238,.374,9,41,.220,80,197,.406,.393,38,59,.644,34,34,68,52,36,7,42,93,225
1983,Derek Smith,SF,21,GSW,27,0,154,21,51,.412,0,2,.000,21,49,.429,.412,17,25,.680,10,28,38,2,0,4,11,40,59
1983,Jim Smith,PF,24,DET,4,0,18,3,4,.750,0,0,,3,4,.750,.750,2,4,.500,0,5,5,0,0,0,0,4,8
1983,Larry Smith,PF,25,GSW,49,41,1433,180,306,.588,0,0,,180,306,.588,.588,53,99,.535,209,276,485,46,36,20,83,186,413
1983,Phil Smith,SG,30,SEA,79,17,1238,175,400,.438,3,8,.375,172,392,.439,.441,101,133,.759,27,103,130,216,44,8,102,113,454
1983,Randy Smith,SG,34,TOT,80,16,1406,273,565,.483,3,18,.167,270,547,.494,.486,114,131,.870,37,59,96,206,56,0,98,139,663
1983,Randy Smith,SG,34,SDC,65,16,1264,244,499,.489,3,16,.188,241,483,.499,.492,101,117,.863,35,53,88,192,54,0,89,122,592
1983,Randy Smith,SG,34,ATL,15,0,142,29,66,.439,0,2,.000,29,64,.453,.439,13,14,.929,2,6,8,14,2,0,9,17,71
1983,Robert Smith,PG,27,TOT,12,0,68,7,24,.292,0,2,.000,7,22,.318,.292,9,10,.900,1,5,6,8,5,0,6,13,23
1983,Robert Smith,PG,27,SDC,5,0,43,2,13,.154,0,1,.000,2,12,.167,.154,7,8,.875,1,2,3,6,4,0,3,7,11
1983,Robert Smith,PG,27,SAS,7,0,25,5,11,.455,0,1,.000,5,10,.500,.455,2,2,1.000,0,3,3,2,1,0,3,6,12
1983,Ricky Sobers,SG,30,WSB,41,39,1438,234,534,.438,23,55,.418,211,479,.441,.460,154,185,.832,35,67,102,218,61,14,147,158,645
1983,Jim Spanarkel,SG,25,DAL,48,4,722,91,197,.462,2,10,.200,89,187,.476,.467,88,113,.779,27,57,84,78,27,3,55,59,272
1983,Rory Sparrow,PG,24,TOT,81,58,2428,392,810,.484,5,22,.227,387,788,.491,.487,147,199,.739,61,169,230,397,107,5,197,255,936
1983,Rory Sparrow,PG,24,ATL,49,49,1548,264,512,.516,3,15,.200,261,497,.525,.519,84,113,.743,39,102,141,238,70,1,126,162,615
1983,Rory Sparrow,PG,24,NYK,32,9,880,128,298,.430,2,7,.286,126,291,.433,.433,63,86,.733,22,67,89,159,37,4,71,93,321
1983,Larry Spriggs,SF,23,CHI,9,0,39,8,20,.400,0,0,,8,20,.400,.400,5,7,.714,2,7,9,3,1,2,2,3,21
1983,Brook Steppe,SG,23,KCK,62,6,606,84,176,.477,1,7,.143,83,169,.491,.480,76,100,.760,25,48,73,68,26,3,55,92,245
1983,Jeff Taylor,SG,23,HOU,44,5,774,64,160,.400,0,1,.000,64,159,.403,.400,30,46,.652,25,53,78,110,40,15,60,82,158
1983,Vince Taylor,SG,22,NYK,31,0,321,37,102,.363,0,0,,37,102,.363,.363,21,32,.656,19,17,36,41,20,2,30,54,95
1983,Terry Teagle,SG,22,HOU,73,44,1708,332,776,.428,10,29,.345,322,747,.431,.434,87,125,.696,74,120,194,150,53,18,137,171,761
1983,Carlos Terry,SG,26,WSB,55,3,514,39,106,.368,0,2,.000,39,104,.375,.368,10,15,.667,27,72,99,46,24,13,20,79,88
1983,Reggie Theus,PG,25,CHI,82,81,2856,749,1567,.478,21,91,.231,728,1476,.493,.485,434,542,.801,91,209,300,484,143,17,321,281,1953
1983,David Thirdkill,SF,22,PHO,49,2,521,74,170,.435,1,7,.143,73,163,.448,.438,45,78,.577,28,44,72,36,19,4,48,93,194
1983,Isiah Thomas*,PG,21,DET,81,81,3093,725,1537,.472,36,125,.288,689,1412,.488,.483,368,518,.710,105,223,328,634,199,29,326,318,1854
1983,Corny Thompson,PF,22,DAL,44,2,520,43,137,.314,0,0,,43,137,.314,.314,36,46,.783,41,79,120,34,12,7,31,92,122
1983,David Thompson*,SG,28,SEA,75,64,2155,445,925,.481,2,10,.200,443,915,.484,.482,298,380,.784,96,174,270,222,47,33,163,142,1190
1983,LaSalle Thompson,C,21,KCK,71,3,987,147,287,.512,0,1,.000,147,286,.514,.512,89,137,.650,133,242,375,33,40,61,96,186,383
1983,Mychal Thompson,C,28,POR,80,80,3017,505,1033,.489,0,1,.000,505,1032,.489,.489,249,401,.621,183,570,753,380,68,110,281,213,1259
1983,Darren Tillis,C,22,TOT,52,4,526,76,181,.420,0,1,.000,76,180,.422,.420,16,28,.571,41,89,130,18,8,30,22,76,168
1983,Darren Tillis,C,22,BOS,15,0,44,7,23,.304,0,1,.000,7,22,.318,.304,2,6,.333,4,5,9,2,0,2,4,8,16
1983,Darren Tillis,C,22,CLE,37,4,482,69,158,.437,0,0,,69,158,.437,.437,14,22,.636,37,84,121,16,8,28,18,68,152
1983,Ray Tolbert,PF,24,TOT,73,2,1107,157,314,.500,0,3,.000,157,311,.505,.500,52,103,.505,72,170,242,50,26,47,83,153,366
1983,Ray Tolbert,PF,24,SEA,45,2,712,100,190,.526,0,2,.000,100,188,.532,.526,24,44,.545,46,105,151,31,16,24,51,97,224
1983,Ray Tolbert,PF,24,DET,28,0,395,57,124,.460,0,1,.000,57,123,.463,.460,28,59,.475,26,65,91,19,10,23,32,56,142
1983,Andrew Toney,SG,25,PHI,81,81,2474,626,1250,.501,22,76,.289,604,1174,.514,.510,324,411,.788,42,183,225,365,80,17,271,255,1598
1983,Linton Townes,SF,23,POR,55,0,516,105,234,.449,9,25,.360,96,209,.459,.468,28,38,.737,30,35,65,31,19,5,33,81,247
1983,Kelly Tripucka,SF,23,DET,58,58,2252,565,1156,.489,14,37,.378,551,1119,.492,.495,392,464,.845,126,138,264,237,67,20,187,157,1536
1983,Trent Tucker,SG,23,NYK,78,59,1830,299,647,.462,14,30,.467,285,617,.462,.473,43,64,.672,75,141,216,195,56,6,70,235,655
1983,Elston Turner,SF,23,DAL,59,16,879,96,238,.403,2,3,.667,94,235,.400,.408,20,30,.667,68,84,152,88,47,0,59,75,214
1983,Terry Tyler,SF,26,DET,82,56,2543,421,880,.478,2,15,.133,419,865,.484,.480,146,196,.745,180,360,540,157,103,160,120,221,990
1983,Darnell Valentine,PG,23,POR,47,36,1298,209,460,.454,0,1,.000,209,459,.455,.454,169,213,.793,34,83,117,293,101,5,131,139,587
1983,Jan van Breda Kolff,SF,31,NJN,13,0,63,5,14,.357,0,0,,5,14,.357,.357,5,6,.833,2,11,13,5,2,2,3,9,15
1983,Kiki Vandeweghe,PF,24,DEN,82,79,2909,841,1537,.547,15,51,.294,826,1486,.556,.552,489,559,.875,124,313,437,203,66,38,177,198,2186
1983,Pete Verhoeven,PF,23,POR,48,0,527,87,171,.509,0,1,.000,87,170,.512,.509,21,31,.677,44,52,96,32,18,9,40,95,195
1983,Jay Vincent,PF,23,DAL,81,73,2726,622,1272,.489,0,3,.000,622,1269,.490,.489,269,343,.784,217,375,592,212,70,45,188,295,1513
1983,Danny Vranes,SF,24,SEA,82,73,2054,226,429,.527,0,1,.000,226,428,.528,.527,115,209,.550,177,248,425,120,53,49,102,254,567
1983,Foots Walker,PG,31,NJN,79,10,1388,114,250,.456,2,12,.167,112,238,.471,.460,116,149,.779,30,106,136,264,78,3,104,134,346
1983,Wally Walker,SF,28,HOU,82,59,2251,362,806,.449,1,4,.250,361,802,.450,.450,72,116,.621,137,236,373,199,37,22,144,202,797
1983,Bill Walton*,C,30,SDC,33,32,1099,200,379,.528,0,0,,200,379,.528,.528,65,117,.556,75,248,323,120,34,119,105,113,465
1983,Bryan Warrick,PG,23,WSB,43,20,727,65,171,.380,0,5,.000,65,166,.392,.380,42,57,.737,15,54,69,126,21,8,71,103,172
1983,Marvin Webster,C,30,NYK,82,0,1472,168,331,.508,0,1,.000,168,330,.509,.508,106,180,.589,176,267,443,49,35,131,102,210,442
1983,Scott Wedman,SF,30,TOT,75,35,1793,374,788,.475,10,32,.313,364,756,.481,.481,85,107,.794,98,184,282,117,43,17,126,228,843
1983,Scott Wedman,SF,30,CLE,35,35,1290,280,583,.480,9,22,.409,271,561,.483,.488,65,77,.844,69,139,208,86,23,11,94,145,634
1983,Scott Wedman,SF,30,BOS,40,0,503,94,205,.459,1,10,.100,93,195,.477,.461,20,30,.667,29,45,74,31,20,6,32,83,209
1983,Paul Westphal*,SG,32,NYK,80,59,1978,318,693,.459,14,48,.292,304,645,.471,.469,148,184,.804,19,96,115,439,87,16,196,180,798
1983,Rory White,SF,23,PHO,65,0,626,127,234,.543,0,1,.000,127,233,.545,.543,70,109,.642,47,58,105,30,16,2,51,54,324
1983,Jerome Whitehead,C,26,SDC,46,23,905,164,306,.536,0,0,,164,306,.536,.536,72,87,.828,105,156,261,42,21,15,65,139,400
1983,Bob Wilkerson,SF,28,CLE,77,11,1702,213,511,.417,0,4,.000,213,507,.420,.417,93,124,.750,62,180,242,189,68,16,160,157,519
1983,Jamaal Wilkes*,SF,29,LAL,80,80,2552,684,1290,.530,0,6,.000,684,1284,.533,.530,203,268,.757,146,197,343,182,65,17,150,221,1571
1983,James Wilkes,SF,24,DET,9,0,129,11,34,.324,0,1,.000,11,33,.333,.324,12,15,.800,9,10,19,10,3,1,5,22,34
1983,Dominique Wilkins*,SF,23,ATL,82,82,2697,601,1220,.493,2,11,.182,599,1209,.495,.493,230,337,.682,226,252,478,129,84,63,180,210,1434
1983,Jeff Wilkins,C,27,UTA,81,34,2307,389,816,.477,0,3,.000,389,813,.478,.477,156,200,.780,154,442,596,132,41,42,186,251,934
1983,Buck Williams,PF,22,NJN,82,82,2961,536,912,.588,0,4,.000,536,908,.590,.588,324,523,.620,365,662,1027,125,91,110,246,270,1396
1983,Freeman Williams,SG,26,UTA,18,3,210,36,101,.356,2,7,.286,34,94,.362,.366,18,25,.720,3,14,17,10,6,1,12,30,92
1983,Gus Williams,PG,29,SEA,80,80,2761,660,1384,.477,2,43,.047,658,1341,.491,.478,278,370,.751,72,133,205,643,182,26,230,117,1600
1983,Herb Williams,C,24,IND,78,74,2513,580,1163,.499,0,7,.000,580,1156,.502,.499,155,220,.705,151,432,583,262,54,171,229,230,1315
1983,Ray Williams,PG,28,KCK,72,68,2170,419,1068,.392,15,74,.203,404,994,.406,.399,256,333,.769,93,234,327,569,120,26,335,248,1109
1983,Rickey Williams,SG,25,UTA,44,0,346,56,135,.415,0,3,.000,56,132,.424,.415,35,53,.660,15,23,38,37,20,4,38,42,147
1983,Rob Williams,PG,21,DEN,74,33,1443,191,468,.408,2,15,.133,189,453,.417,.410,131,174,.753,37,99,136,361,89,12,185,221,515
1983,Sam Williams,PF,23,GSW,75,28,1533,252,479,.526,0,1,.000,252,478,.527,.526,123,171,.719,153,240,393,45,71,89,101,244,627
1983,Sly Williams,PF,25,NYK,68,6,1385,314,647,.485,2,19,.105,312,628,.497,.487,176,259,.680,94,196,290,133,73,3,133,166,806
1983,Bill Willoughby,SF,25,TOT,62,0,1146,147,324,.454,6,14,.429,141,310,.455,.463,43,55,.782,63,138,201,64,25,17,61,139,343
1983,Bill Willoughby,SF,25,SAS,52,0,1062,136,295,.461,6,13,.462,130,282,.461,.471,41,53,.774,61,129,190,56,24,16,56,123,319
1983,Bill Willoughby,SF,25,NJN,10,0,84,11,29,.379,0,1,.000,11,28,.393,.379,2,2,1.000,2,9,11,8,1,1,5,16,24
1983,Brian Winters,SG,30,MIL,57,12,1361,255,587,.434,22,68,.324,233,519,.449,.453,73,85,.859,35,75,110,156,45,4,81,132,605
1983,Al Wood,SF,24,SDC,76,47,1822,343,740,.464,15,50,.300,328,690,.475,.474,124,161,.770,96,140,236,134,55,36,111,188,825
1983,Mike Woodson,SG,24,KCK,81,3,2426,584,1154,.506,7,33,.212,577,1121,.515,.509,298,377,.790,84,164,248,254,137,59,174,203,1473
1983,Orlando Woolridge,SF,23,CHI,57,38,1627,361,622,.580,0,3,.000,361,619,.583,.580,217,340,.638,122,176,298,97,38,44,157,177,939
1983,James Worthy*,SF,21,LAL,77,1,1970,447,772,.579,1,4,.250,446,768,.581,.580,138,221,.624,157,242,399,132,91,64,178,221,1033
1983,Jim Zoet,C,29,DET,7,0,30,1,5,.200,0,0,,1,5,.200,.200,0,0,,3,5,8,1,1,3,4,9,2
1984,Kareem Abdul-Jabbar*,C,36,LAL,80,80,2622,716,1238,.578,0,1,.000,716,1237,.579,.578,285,394,.723,169,418,587,211,55,143,221,211,1717
1984,Alvan Adams,C,29,PHO,70,13,1452,269,582,.462,0,4,.000,269,578,.465,.462,132,160,.825,118,201,319,219,73,31,117,195,670
1984,Mark Aguirre,SF,24,DAL,79,79,2900,925,1765,.524,15,56,.268,910,1709,.532,.528,465,621,.749,161,308,469,358,80,22,285,246,2330
1984,Danny Ainge,SG,24,BOS,71,3,1154,166,361,.460,6,22,.273,160,339,.472,.468,46,56,.821,29,87,116,162,41,4,70,143,384
1984,J.J. Anderson,SF,23,UTA,48,0,311,55,130,.423,0,3,.000,55,127,.433,.423,12,29,.414,38,25,63,22,15,9,20,28,122
1984,Richard Anderson,PF,23,DEN,78,17,1380,272,638,.426,3,19,.158,269,619,.435,.429,116,150,.773,136,270,406,193,46,28,109,183,663
1984,Tiny Archibald*,PG,35,MIL,46,46,1038,136,279,.487,4,18,.222,132,261,.506,.495,64,101,.634,16,60,76,160,33,0,78,78,340
1984,Ken Austin,SF,22,DET,7,0,28,6,13,.462,0,0,,6,13,.462,.462,0,0,,2,1,3,1,1,1,3,7,12
1984,John Bagley,PG,23,CLE,76,19,1712,257,607,.423,2,17,.118,255,590,.432,.425,157,198,.793,49,107,156,333,78,4,170,113,673
1984,James Bailey,PF,26,HOU,73,0,1174,254,517,.491,0,1,.000,254,516,.492,.491,138,192,.719,104,190,294,79,33,40,101,197,646
1984,Thurl Bailey,PF,22,UTA,81,54,2009,302,590,.512,0,0,,302,590,.512,.512,88,117,.752,115,349,464,129,38,122,105,193,692
1984,Greg Ballard,SF,29,WSB,82,82,2701,510,1061,.481,2,15,.133,508,1046,.486,.482,166,208,.798,140,348,488,290,94,35,142,214,1188
1984,Gene Banks,PF,24,SAS,80,66,2600,424,747,.568,1,6,.167,423,741,.571,.568,200,270,.741,204,378,582,254,105,23,166,256,1049
1984,Dave Batton,C,27,SAS,4,0,31,5,10,.500,0,0,,5,10,.500,.500,0,0,,1,3,4,3,0,3,4,5,10
1984,Kent Benson,C,29,DET,82,58,1734,248,451,.550,0,1,.000,248,450,.551,.550,83,101,.822,117,292,409,130,71,53,79,230,579
1984,Larry Bird*,PF,27,BOS,79,77,3028,758,1542,.492,18,73,.247,740,1469,.504,.497,374,421,.888,181,615,796,520,144,69,237,197,1908
1984,Otis Birdsong,SG,28,NJN,69,57,2168,583,1147,.508,5,20,.250,578,1127,.513,.510,194,319,.608,74,96,170,266,86,17,170,180,1365
1984,Rolando Blackman,SG,24,DAL,81,81,3025,721,1320,.546,1,11,.091,720,1309,.550,.547,372,458,.812,124,249,373,288,56,37,169,127,1815
1984,Tom Boswell,PF,30,UTA,38,0,261,28,52,.538,1,1,1.000,27,51,.529,.548,16,21,.762,28,36,64,16,9,0,13,58,73
1984,Charles Bradley,SG,24,SEA,8,0,39,3,7,.429,0,0,,3,7,.429,.429,5,7,.714,0,3,3,5,0,1,8,6,11
1984,Mike Bratz,PG,28,GSW,82,0,1428,213,521,.409,15,51,.294,198,470,.421,.423,120,137,.876,41,102,143,252,84,6,109,155,561
1984,Randy Breuer,C,23,MIL,57,8,472,68,177,.384,0,0,,68,177,.384,.384,32,46,.696,48,61,109,17,11,38,35,98,168
1984,Ron Brewer,SG,28,TOT,53,8,992,179,403,.444,3,14,.214,176,389,.452,.448,52,67,.776,22,41,63,50,24,21,40,64,413
1984,Ron Brewer,SG,28,GSW,13,3,210,27,58,.466,0,1,.000,27,57,.474,.466,11,17,.647,5,8,13,6,6,5,7,10,65
1984,Ron Brewer,SG,28,SAS,40,5,782,152,345,.441,3,13,.231,149,332,.449,.445,41,50,.820,17,33,50,44,18,16,33,54,348
1984,Junior Bridgeman,SF,30,MIL,81,10,2431,509,1094,.465,6,31,.194,503,1063,.473,.468,196,243,.807,80,252,332,265,53,14,148,224,1220
1984,Michael Brooks,SF,25,SDC,47,30,1405,213,445,.479,0,5,.000,213,440,.484,.479,104,151,.689,142,200,342,88,50,14,78,125,530
1984,Fred Brown,SG,35,SEA,71,1,1129,258,506,.510,9,34,.265,249,472,.528,.519,77,86,.895,14,48,62,194,49,2,70,84,602
1984,Rickey Brown,C,25,ATL,68,3,785,94,201,.468,0,0,,94,201,.468,.468,48,65,.738,67,114,181,29,18,23,53,161,236
1984,Wallace Bryant,C,24,CHI,29,0,317,52,133,.391,0,0,,52,133,.391,.391,14,33,.424,37,43,80,13,9,11,16,48,118
1984,Quinn Buckner,PG,29,BOS,79,0,1249,138,323,.427,0,6,.000,138,317,.435,.427,48,74,.649,41,96,137,214,84,3,100,187,324
1984,Don Buse,PG,33,KCK,76,10,1327,150,352,.426,18,59,.305,132,293,.451,.452,63,80,.788,29,87,116,303,86,1,87,62,381
1984,Kenny Carr,PF,28,POR,82,57,2455,518,923,.561,0,5,.000,518,918,.564,.561,247,367,.673,208,434,642,157,68,33,202,274,1283
1984,M.L. Carr,SF,33,BOS,60,1,585,70,171,.409,3,15,.200,67,156,.429,.418,42,48,.875,26,49,75,49,17,4,46,67,185
1984,Joe Barry Carroll,C,25,GSW,80,80,2962,663,1390,.477,0,1,.000,663,1389,.477,.477,313,433,.723,235,401,636,198,103,142,268,244,1639
1984,Butch Carter,SG,25,IND,73,54,2045,413,862,.479,15,46,.326,398,816,.488,.488,136,178,.764,70,83,153,206,128,13,141,211,977
1984,Howard Carter,SG,22,DEN,55,5,688,145,316,.459,5,19,.263,140,297,.471,.467,47,61,.770,38,48,86,71,19,4,42,81,342
1984,Bill Cartwright,C,26,NYK,77,77,2487,453,808,.561,0,1,.000,453,807,.561,.561,404,502,.805,195,454,649,107,44,97,200,262,1310
1984,Harvey Catchings,PF,32,MIL,69,3,1156,61,153,.399,0,1,.000,61,152,.401,.399,22,42,.524,89,182,271,43,25,81,57,172,144
1984,Tom Chambers,PF,24,SEA,82,44,2570,554,1110,.499,0,12,.000,554,1098,.505,.499,375,469,.800,219,313,532,133,47,51,192,309,1483
1984,Maurice Cheeks*,PG,27,PHI,75,75,2494,386,702,.550,8,20,.400,378,682,.554,.556,170,232,.733,44,161,205,478,171,20,182,196,950
1984,Carlos Clark,SG,23,BOS,31,0,127,19,52,.365,0,2,.000,19,50,.380,.365,16,18,.889,7,10,17,17,8,1,12,13,54
1984,Don Collins,SG,25,GSW,61,6,957,187,387,.483,1,5,.200,186,382,.487,.484,65,89,.730,62,67,129,67,43,14,80,119,440
1984,Leroy Combs,SF,23,IND,48,0,446,81,163,.497,0,3,.000,81,160,.506,.497,56,91,.615,19,37,56,38,23,18,46,49,218
1984,Lester Conner,SG,24,GSW,82,82,2573,360,730,.493,1,6,.167,359,724,.496,.494,186,259,.718,132,173,305,401,162,12,143,176,907
1984,Darwin Cook,PG,25,NJN,82,31,1870,304,687,.443,11,46,.239,293,641,.457,.451,95,126,.754,51,105,156,356,164,36,142,184,714
1984,Jeff Cook,C,27,CLE,81,21,1950,188,387,.486,1,2,.500,187,385,.486,.487,94,130,.723,174,310,484,123,68,47,91,282,471
1984,Michael Cooper,SG,27,LAL,82,9,2387,273,549,.497,38,121,.314,235,428,.549,.532,155,185,.838,53,209,262,482,113,67,148,267,739
1984,Wayne Cooper,C,27,POR,81,38,1662,304,663,.459,0,7,.000,304,656,.463,.459,185,230,.804,176,300,476,76,26,106,110,247,793
1984,Dave Corzine,C,27,CHI,82,82,2674,385,824,.467,3,9,.333,382,815,.469,.469,231,275,.840,169,406,575,202,58,120,175,227,1004
1984,Charlie Criss,PG,35,TOT,15,0,215,20,52,.385,1,6,.167,19,46,.413,.394,12,16,.750,5,15,20,38,8,0,10,11,53
1984,Charlie Criss,PG,35,MIL,6,0,107,11,30,.367,1,6,.167,10,24,.417,.383,7,11,.636,2,7,9,17,5,0,4,7,30
1984,Charlie Criss,PG,35,ATL,9,0,108,9,22,.409,0,0,,9,22,.409,.409,5,5,1.000,3,8,11,21,3,0,6,4,23
1984,Geoff Crompton,C,28,CLE,7,0,23,1,8,.125,0,0,,1,8,.125,.125,3,6,.500,6,3,9,1,1,1,4,4,5
1984,Russell Cross,C,22,GSW,45,0,354,64,112,.571,0,0,,64,112,.571,.571,38,91,.418,35,47,82,22,12,7,19,58,166
1984,Pat Cummings,PF,27,DAL,80,80,2492,452,915,.494,0,2,.000,452,913,.495,.494,141,190,.742,151,507,658,158,64,23,146,282,1045
1984,Terry Cummings,PF,22,SDC,81,80,2907,737,1491,.494,0,3,.000,737,1488,.495,.494,380,528,.720,323,454,777,139,92,57,218,298,1854
1984,Earl Cureton,C,26,DET,73,0,907,81,177,.458,0,1,.000,81,176,.460,.458,31,59,.525,86,201,287,36,24,31,55,143,193
1984,Quintin Dailey,SG,23,CHI,82,42,2449,583,1229,.474,4,32,.125,579,1197,.484,.476,321,396,.811,61,174,235,254,109,11,220,218,1491
1984,Adrian Dantley*,SF,28,UTA,79,79,2984,802,1438,.558,1,4,.250,801,1434,.559,.558,813,946,.859,179,269,448,310,61,4,263,201,2418
1984,Brad Davis,PG,28,DAL,81,81,2665,345,651,.530,7,38,.184,338,613,.551,.535,199,238,.836,41,146,187,561,94,13,166,218,896
1984,Charles Davis,SF,25,WSB,46,0,467,103,218,.472,1,9,.111,102,209,.488,.475,24,39,.615,34,69,103,30,14,10,36,58,231
1984,Johnny Davis,PG,28,ATL,75,72,2079,354,800,.443,0,8,.000,354,792,.447,.443,217,256,.848,53,86,139,326,62,6,134,146,925
1984,Walter Davis,SG,29,PHO,78,70,2546,652,1274,.512,20,87,.230,632,1187,.532,.520,233,270,.863,38,164,202,429,107,12,213,202,1557
1984,Darryl Dawkins,C,27,NJN,81,80,2417,507,855,.593,2,5,.400,505,850,.594,.594,341,464,.735,159,382,541,123,60,136,231,386,1357
1984,Darren Daye,SF,23,WSB,75,0,1174,180,408,.441,0,6,.000,180,402,.448,.441,95,133,.714,90,98,188,176,38,12,96,154,455
1984,Kenny Dennard,PF,25,DEN,43,0,413,36,99,.364,3,10,.300,33,89,.371,.379,15,24,.625,37,64,101,45,23,8,29,83,90
1984,James Donaldson,C,26,SDC,82,67,2525,360,604,.596,0,0,,360,604,.596,.596,249,327,.761,165,484,649,90,40,139,171,214,969
1984,John Drew,SF,29,UTA,81,4,1797,511,1067,.479,6,22,.273,505,1045,.483,.482,402,517,.778,146,192,338,135,88,2,192,208,1430
1984,Larry Drew,PG,25,KCK,73,73,2363,474,1026,.462,3,10,.300,471,1016,.464,.463,243,313,.776,33,113,146,558,121,10,194,170,1194
1984,Clyde Drexler*,SG,21,POR,82,3,1408,252,559,.451,1,4,.250,251,555,.452,.452,123,169,.728,112,123,235,153,107,29,123,209,628
1984,Mike Dunleavy,PG,29,MIL,17,12,404,70,127,.551,19,45,.422,51,82,.622,.626,32,40,.800,6,22,28,78,12,1,36,51,191
1984,T.R. Dunn,SG,28,DEN,80,74,2705,174,370,.470,0,1,.000,174,369,.472,.470,106,145,.731,195,379,574,228,173,32,97,233,454
1984,Mark Eaton,C,27,UTA,82,78,2139,194,416,.466,0,1,.000,194,415,.467,.466,73,123,.593,148,447,595,113,25,351,98,303,461
1984,Jerry Eaves,PG,24,UTA,80,1,1034,132,293,.451,0,6,.000,132,287,.460,.451,92,132,.697,29,56,85,200,33,5,93,90,356
1984,Keith Edmonson,SG,23,TOT,55,0,622,158,321,.492,0,0,,158,321,.492,.492,94,126,.746,46,42,88,34,26,7,61,83,410
1984,Keith Edmonson,SG,23,SAS,40,0,521,135,274,.493,0,0,,135,274,.493,.493,76,101,.752,40,30,70,27,22,6,45,67,346
1984,Keith Edmonson,SG,23,DEN,15,0,101,23,47,.489,0,0,,23,47,.489,.489,18,25,.720,6,12,18,7,4,1,16,16,64
1984,Franklin Edwards,PG,24,PHI,60,0,654,84,221,.380,0,1,.000,84,220,.382,.380,34,48,.708,12,47,59,90,31,5,46,78,202
1984,James Edwards,C,28,PHO,72,67,1897,438,817,.536,0,1,.000,438,816,.537,.536,183,254,.720,108,240,348,184,23,30,140,254,1059
1984,Craig Ehlo,SG,22,HOU,7,0,63,11,27,.407,0,0,,11,27,.407,.407,1,1,1.000,4,5,9,6,3,0,3,13,23
1984,Dale Ellis,SF,23,DAL,67,2,1059,225,493,.456,12,29,.414,213,464,.459,.469,87,121,.719,106,144,250,56,41,9,78,118,549
1984,Len Elmore,PF,31,NYK,65,5,832,64,157,.408,0,0,,64,157,.408,.408,27,38,.711,62,103,165,30,29,30,46,153,155
1984,Chris Engler,C,24,GSW,46,1,360,33,83,.398,0,0,,33,83,.398,.398,14,23,.609,27,70,97,11,9,3,24,68,80
1984,Alex English*,SF,30,DEN,82,77,2870,907,1714,.529,1,7,.143,906,1707,.531,.529,352,427,.824,216,248,464,406,83,95,222,252,2167
1984,Julius Erving*,SF,33,PHI,77,77,2683,678,1324,.512,7,21,.333,671,1303,.515,.515,364,483,.754,190,342,532,309,141,139,230,217,1727
1984,Mike Evans,PG,28,DEN,78,5,1687,243,564,.431,32,89,.360,211,475,.444,.459,111,131,.847,23,115,138,288,61,4,117,175,629
1984,Eric Fernsten,PF,30,NYK,32,0,402,29,52,.558,0,0,,29,52,.558,.558,25,34,.735,29,57,86,11,16,8,19,49,83
1984,Sleepy Floyd,PG,23,GSW,77,73,2555,484,1045,.463,8,45,.178,476,1000,.476,.467,315,386,.816,87,184,271,269,103,31,196,216,1291
1984,Phil Ford,PG,27,HOU,81,55,2020,236,470,.502,2,15,.133,234,455,.514,.504,98,117,.838,28,109,137,410,59,8,135,243,572
1984,Rod Foster,PG,23,PHO,80,34,1424,260,580,.448,22,84,.262,238,496,.480,.467,122,155,.787,39,81,120,172,54,9,108,193,664
1984,World B. Free,SG,30,CLE,75,71,2375,626,1407,.445,22,69,.319,604,1338,.451,.453,395,504,.784,89,128,217,226,94,8,154,214,1669
1984,Bill Garnett,PF,23,DAL,80,34,1529,141,299,.472,0,2,.000,141,297,.475,.472,129,176,.733,123,208,331,128,44,66,68,217,411
1984,Calvin Garrett,SF,27,LAL,41,0,478,78,152,.513,2,6,.333,76,146,.521,.520,30,39,.769,24,47,71,31,12,2,34,62,188
1984,John Garris,PF,24,CLE,33,1,267,52,102,.510,0,0,,52,102,.510,.510,27,34,.794,35,42,77,10,8,6,11,40,131
1984,George Gervin*,SG,31,SAS,76,76,2584,765,1561,.490,10,24,.417,755,1537,.491,.493,427,507,.842,106,207,313,220,79,47,224,219,1967
1984,Mike Gibson,PF,23,WSB,32,0,229,21,55,.382,0,0,,21,55,.382,.382,11,17,.647,29,37,66,9,5,7,14,30,53
1984,Artis Gilmore*,C,34,SAS,64,59,2034,351,556,.631,0,3,.000,351,553,.635,.631,280,390,.718,213,449,662,70,36,132,149,229,982
1984,Mike Glenn,SG,28,ATL,81,0,1503,312,554,.563,1,2,.500,311,552,.563,.564,56,70,.800,17,87,104,171,46,5,63,146,681
1984,Mike Gminski,C,24,NJN,82,2,1655,237,462,.513,0,3,.000,237,459,.516,.513,147,184,.799,161,272,433,92,37,70,120,162,621
1984,Stewart Granger,PG,22,CLE,56,13,738,97,226,.429,4,13,.308,93,213,.437,.438,53,70,.757,8,47,55,134,24,0,57,97,251
1984,Rickey Green,PG,29,UTA,81,81,2768,439,904,.486,2,17,.118,437,887,.493,.487,192,234,.821,56,174,230,748,215,13,172,155,1072
1984,Sidney Green,PF,23,CHI,49,0,667,100,228,.439,0,0,,100,228,.439,.439,55,77,.714,58,116,174,25,18,17,60,128,255
1984,Dave Greenwood,PF,26,CHI,78,76,2718,369,753,.490,0,1,.000,369,752,.491,.490,213,289,.737,214,572,786,139,67,72,149,265,951
1984,Kevin Grevey,SG,30,MIL,64,3,923,178,395,.451,15,53,.283,163,342,.477,.470,75,84,.893,30,51,81,75,27,4,45,95,446
1984,Darrell Griffith,SG,25,UTA,82,82,2650,697,1423,.490,91,252,.361,606,1171,.518,.522,151,217,.696,95,243,338,283,114,23,243,202,1636
1984,Ernie Grunfeld,SG,28,NYK,76,6,1119,166,362,.459,2,9,.222,164,353,.465,.461,64,83,.771,24,97,121,108,43,7,71,151,398
1984,Bob Hansen,SG,23,UTA,55,0,419,65,145,.448,0,8,.000,65,137,.474,.448,18,28,.643,13,35,48,44,15,4,35,62,148
1984,Bill Hanzlik,SF,26,DEN,80,14,1469,132,306,.431,3,12,.250,129,294,.439,.436,167,207,.807,66,139,205,252,68,19,109,255,434
1984,Derek Harper,PG,22,DAL,82,1,1712,200,451,.443,3,26,.115,197,425,.464,.447,66,98,.673,53,119,172,239,95,21,111,143,469
1984,Scott Hastings,PF,23,ATL,68,8,1135,111,237,.468,1,4,.250,110,233,.472,.470,82,104,.788,96,174,270,46,40,36,66,220,305
1984,Steve Hawes,PF,33,SEA,79,0,1153,114,237,.481,1,4,.250,113,233,.485,.483,61,78,.782,50,170,220,99,24,16,52,144,290
1984,Elvin Hayes*,PF,38,HOU,81,4,994,158,389,.406,0,2,.000,158,387,.408,.406,86,132,.652,87,173,260,71,16,28,82,123,402
1984,Steve Hayes,C,28,SEA,43,0,253,26,50,.520,0,0,,26,50,.520,.520,5,14,.357,19,43,62,13,5,18,13,52,57
1984,Gerald Henderson,PG,28,BOS,78,78,2088,376,718,.524,20,57,.351,356,661,.539,.538,136,177,.768,68,79,147,300,117,14,161,209,908
1984,Rod Higgins,SF,24,CHI,78,6,1577,193,432,.447,1,22,.045,192,410,.468,.448,113,156,.724,87,119,206,116,49,29,76,161,500
1984,Johnny High,PG,26,PHO,29,9,512,18,52,.346,0,2,.000,18,50,.360,.346,10,29,.345,16,50,66,51,40,11,38,84,46
1984,Armond Hill,PG,30,ATL,15,2,181,14,46,.304,0,0,,14,46,.304,.304,17,21,.810,2,8,10,35,7,0,14,30,45
1984,Roy Hinson,SF,22,CLE,80,61,1858,184,371,.496,0,0,,184,371,.496,.496,69,117,.590,175,324,499,69,31,145,109,306,437
1984,Craig Hodges,SG,23,SDC,76,28,1571,258,573,.450,10,46,.217,248,527,.471,.459,66,88,.750,22,64,86,116,58,1,85,166,592
1984,Lionel Hollins,PG,30,DET,32,0,216,24,63,.381,0,2,.000,24,61,.393,.381,11,13,.846,4,18,22,62,13,1,24,26,59
1984,Phil Hubbard,SF,27,CLE,80,6,1799,321,628,.511,0,1,.000,321,627,.512,.511,221,299,.739,172,208,380,86,71,6,115,244,863
1984,Geoff Huston,PG,26,CLE,77,56,2041,348,699,.498,2,11,.182,346,688,.503,.499,110,154,.714,32,64,96,413,38,1,145,126,808
1984,Marc Iavaroni,PF,27,PHI,78,71,1532,149,322,.463,0,2,.000,149,320,.466,.463,97,131,.740,91,219,310,95,36,55,124,222,395
1984,Dan Issel*,C,35,DEN,76,66,2076,569,1153,.493,4,19,.211,565,1134,.498,.495,364,428,.850,112,401,513,173,60,44,122,182,1506
1984,Tracy Jackson,SG,24,IND,2,0,10,1,4,.250,0,0,,1,4,.250,.250,4,4,1.000,1,0,1,0,0,0,1,3,6
1984,Clay Johnson,SG,27,SEA,25,0,176,20,50,.400,1,1,1.000,19,49,.388,.410,14,22,.636,6,6,12,14,8,2,12,24,55
1984,Clemon Johnson,C,27,PHI,80,10,1721,193,412,.468,0,0,,193,412,.468,.468,69,113,.611,131,267,398,55,35,65,95,205,455
1984,Dennis Johnson*,SG,29,BOS,80,78,2665,384,878,.437,4,32,.125,380,846,.449,.440,281,330,.852,87,193,280,338,93,57,172,251,1053
1984,Eddie Johnson,SG,28,ATL,67,43,1893,353,798,.442,16,43,.372,337,755,.446,.452,164,213,.770,31,115,146,374,58,7,173,155,886
1984,Eddie Johnson,SF,24,KCK,82,82,2920,753,1552,.485,20,64,.313,733,1488,.493,.492,268,331,.810,165,290,455,296,76,21,213,266,1794
1984,Frank Johnson,PG,25,WSB,82,81,2686,392,840,.467,11,43,.256,381,797,.478,.473,187,252,.742,58,126,184,567,96,6,191,174,982
1984,George Johnson,SF,27,IND,81,20,2073,411,884,.465,11,47,.234,400,837,.478,.471,223,270,.826,139,321,460,195,82,49,186,256,1056
1984,Magic Johnson*,PG,24,LAL,67,66,2567,441,780,.565,6,29,.207,435,751,.579,.569,290,358,.810,99,392,491,875,150,49,306,169,1178
1984,Marques Johnson,SF,27,MIL,74,74,2715,646,1288,.502,2,13,.154,644,1275,.505,.502,241,340,.709,173,307,480,315,115,45,180,194,1535
1984,Mickey Johnson,PF,31,GSW,78,25,2122,359,852,.421,5,29,.172,354,823,.430,.424,339,432,.785,198,320,518,219,101,30,216,290,1062
1984,Reggie Johnson,PF,26,NJN,72,4,818,127,256,.496,0,1,.000,127,255,.498,.496,92,126,.730,53,85,138,40,24,18,59,141,346
1984,Steve Johnson,C,26,TOT,81,21,1487,302,540,.559,0,0,,302,540,.559,.559,165,287,.575,162,256,418,81,37,69,164,307,769
1984,Steve Johnson,C,26,KCK,50,12,893,189,342,.553,0,0,,189,342,.553,.553,101,177,.571,94,158,252,63,22,48,105,188,479
1984,Steve Johnson,C,26,CHI,31,9,594,113,198,.571,0,0,,113,198,.571,.571,64,110,.582,68,98,166,18,15,21,59,119,290
1984,Vinnie Johnson,SG,27,DET,82,0,1909,426,901,.473,4,19,.211,422,882,.478,.475,207,275,.753,130,107,237,271,44,19,135,196,1063
1984,Bobby Jones*,PF,32,PHI,75,0,1761,226,432,.523,0,1,.000,226,431,.524,.523,167,213,.784,92,231,323,187,107,103,101,199,619
1984,Caldwell Jones,C,33,HOU,81,73,2506,318,633,.502,1,3,.333,317,630,.503,.503,164,196,.837,168,414,582,156,46,80,158,335,801
1984,Charles Jones,PF,26,PHI,1,0,3,0,1,.000,0,0,,0,1,.000,.000,1,4,.250,0,0,0,0,0,0,0,1,1
1984,Edgar Jones,PF,27,SAS,81,33,1770,322,644,.500,6,19,.316,316,625,.506,.505,176,242,.727,143,306,449,85,64,107,125,298,826
1984,Hutch Jones,SF,24,SDC,4,0,18,0,3,.000,0,0,,0,3,.000,.000,1,4,.250,0,0,0,0,1,0,2,0,1
1984,Major Jones,PF,30,HOU,57,5,473,70,130,.538,0,0,,70,130,.538,.538,30,49,.612,33,82,115,28,14,14,30,63,170
1984,Mark Jones,PG,22,NJN,6,0,16,3,6,.500,0,1,.000,3,5,.600,.500,1,2,.500,2,0,2,5,0,0,2,2,7
1984,Eddie Jordan,PG,29,TOT,16,0,210,17,49,.347,0,3,.000,17,46,.370,.347,8,12,.667,3,14,17,44,25,0,26,37,42
1984,Eddie Jordan,PG,29,POR,13,0,183,13,41,.317,0,3,.000,13,38,.342,.317,7,10,.700,3,10,13,39,21,0,18,32,33
1984,Eddie Jordan,PG,29,LAL,3,0,27,4,8,.500,0,0,,4,8,.500,.500,1,2,.500,0,4,4,5,4,0,8,5,9
1984,Rich Kelley,C,30,UTA,75,30,1674,132,264,.500,0,0,,132,264,.500,.500,124,162,.765,140,350,490,157,55,29,148,273,388
1984,Clark Kellogg,PF,22,IND,79,79,2676,619,1193,.519,7,21,.333,612,1172,.522,.522,261,340,.768,230,489,719,234,121,28,218,242,1506
1984,Greg Kelser,SF,26,SDC,80,21,1783,313,603,.519,2,6,.333,311,597,.521,.521,250,356,.702,188,203,391,91,68,31,195,249,878
1984,Albert King,SF,24,NJN,79,53,2103,465,946,.492,3,22,.136,462,924,.500,.493,232,295,.786,125,263,388,203,91,33,208,258,1165
1984,Bernard King*,SF,27,NYK,77,76,2667,795,1391,.572,0,4,.000,795,1387,.573,.572,437,561,.779,123,271,394,164,75,17,197,273,2027
1984,Reggie King,SF,26,SEA,77,42,2086,233,448,.520,0,2,.000,233,446,.522,.520,136,206,.660,134,336,470,179,54,24,127,159,602
1984,Greg Kite,C,22,BOS,35,1,197,30,66,.455,0,0,,30,66,.455,.455,5,16,.313,27,35,62,7,1,5,20,42,65
1984,Billy Knight,SF,31,KCK,75,39,1885,358,729,.491,4,14,.286,354,715,.495,.494,243,283,.859,89,166,255,160,54,6,155,122,963
1984,Joe Kopicki,PF,23,WSB,59,2,678,64,132,.485,1,7,.143,63,125,.504,.489,91,112,.813,64,102,166,46,15,5,39,71,220
1984,Bruce Kuczenski,PF,22,TOT,15,2,119,10,37,.270,0,0,,10,37,.270,.270,8,12,.667,7,16,23,8,1,1,15,18,28
1984,Bruce Kuczenski,PF,22,NJN,7,0,28,4,12,.333,0,0,,4,12,.333,.333,3,6,.500,3,5,8,4,0,0,2,3,11
1984,Bruce Kuczenski,PF,22,PHI,3,2,40,1,8,.125,0,0,,1,8,.125,.125,1,2,.500,1,5,6,2,1,1,5,7,3
1984,Bruce Kuczenski,PF,22,IND,5,0,51,5,17,.294,0,0,,5,17,.294,.294,4,4,1.000,3,6,9,2,0,0,8,8,14
1984,Mitch Kupchak,PF,29,LAL,34,3,324,41,108,.380,0,1,.000,41,107,.383,.380,22,34,.647,35,52,87,7,4,6,22,46,104
1984,Bill Laimbeer,C,26,DET,82,82,2864,553,1044,.530,0,11,.000,553,1033,.535,.530,316,365,.866,329,674,1003,149,49,84,151,273,1422
1984,Jeff Lamp,SF,24,POR,64,0,660,128,261,.490,2,13,.154,126,248,.508,.494,60,67,.896,23,40,63,51,22,4,52,67,318
1984,Mark Landsberger,PF,28,ATL,35,0,335,19,51,.373,0,0,,19,51,.373,.373,15,26,.577,42,77,119,10,6,3,21,32,53
1984,Bob Lanier*,C,35,MIL,72,72,2007,392,685,.572,0,3,.000,392,682,.575,.572,194,274,.708,141,314,455,186,58,51,163,228,978
1984,Allen Leavell,PG,26,HOU,82,27,2009,349,731,.477,11,71,.155,338,660,.512,.485,238,286,.832,31,86,117,459,107,12,184,199,947
1984,Ronnie Lester,PG,25,CHI,43,3,687,78,188,.415,1,5,.200,77,183,.421,.418,75,87,.862,20,26,46,168,30,6,72,59,232
1984,Fat Lever,PG,23,POR,81,22,2010,313,701,.447,3,15,.200,310,686,.452,.449,159,214,.743,96,122,218,372,135,31,125,178,788
1984,Cliff Levingston,PF,23,DET,80,24,1746,229,436,.525,0,3,.000,229,433,.529,.525,125,186,.672,234,311,545,109,44,78,77,281,583
1984,Steve Lingenfelter,PF,25,SAS,3,0,14,1,1,1.000,0,0,,1,1,1.000,1.000,0,2,.000,3,1,4,1,0,0,1,6,2
1984,Alton Lister,PF,25,MIL,82,72,1955,256,512,.500,0,0,,256,512,.500,.500,114,182,.626,156,447,603,110,41,140,153,327,626
1984,Lewis Lloyd,SG,24,HOU,82,82,2578,610,1182,.516,3,13,.231,607,1169,.519,.517,235,298,.789,128,167,295,321,102,44,245,211,1458
1984,Darrell Lockhart,C,23,SAS,2,0,14,2,2,1.000,0,0,,2,2,1.000,1.000,0,0,,0,3,3,0,0,0,2,5,4
1984,Kevin Loder,SF,24,TOT,11,0,137,19,43,.442,1,3,.333,18,40,.450,.453,9,13,.692,7,11,18,14,3,5,11,16,48
1984,Kevin Loder,SF,24,KCK,10,0,133,19,43,.442,1,3,.333,18,40,.450,.453,9,13,.692,7,11,18,14,3,5,11,15,48
1984,Kevin Loder,SF,24,SDC,1,0,4,0,0,,0,0,,0,0,,,0,0,,0,0,0,0,0,0,0,1,0
1984,John Long,SG,27,DET,82,82,2514,545,1155,.472,1,5,.200,544,1150,.473,.472,243,275,.884,139,150,289,205,93,18,143,199,1334
1984,Sidney Lowe,PG,24,IND,78,2,1238,107,259,.413,2,18,.111,105,241,.436,.417,108,139,.777,30,92,122,269,93,5,106,112,324
1984,John Lucas,PG,30,SAS,63,39,1807,275,595,.462,19,69,.275,256,526,.487,.478,120,157,.764,23,157,180,673,92,5,147,123,689
1984,Maurice Lucas,PF,31,PHO,75,69,2309,451,908,.497,0,5,.000,451,903,.499,.497,293,383,.765,208,517,725,203,55,39,177,235,1195
1984,Rudy Macklin,SF,25,NYK,8,0,65,12,30,.400,0,0,,12,30,.400,.400,11,13,.846,5,6,11,3,1,0,6,17,35
1984,Kyle Macy,PG,26,PHO,82,45,2402,357,713,.501,23,70,.329,334,643,.519,.517,95,114,.833,49,137,186,353,123,6,116,181,832
1984,Rick Mahorn,PF,25,WSB,82,82,2701,307,605,.507,0,0,,307,605,.507,.507,125,192,.651,169,569,738,131,62,123,142,358,739
1984,Jeff Malone,SG,22,WSB,81,2,1976,408,918,.444,24,74,.324,384,844,.455,.458,142,172,.826,57,98,155,151,23,13,110,162,982
1984,Moses Malone*,C,28,PHI,71,71,2613,532,1101,.483,0,4,.000,532,1097,.485,.483,545,727,.750,352,598,950,96,71,110,250,188,1609
1984,Pace Mannion,SF,23,GSW,57,0,469,50,126,.397,3,13,.231,47,113,.416,.409,18,23,.783,23,36,59,47,25,2,23,63,121
1984,Wes Matthews,PG,24,TOT,20,5,388,61,131,.466,1,8,.125,60,123,.488,.469,27,36,.750,7,20,27,83,16,3,40,45,150
1984,Wes Matthews,PG,24,ATL,6,0,96,16,30,.533,0,1,.000,16,29,.552,.533,18,22,.818,1,3,4,21,5,1,10,13,50
1984,Wes Matthews,PG,24,PHI,14,5,292,45,101,.446,1,7,.143,44,94,.468,.450,9,14,.643,6,17,23,62,11,2,30,32,100
1984,Cedric Maxwell,SF,28,BOS,80,78,2502,317,596,.532,1,6,.167,316,590,.536,.533,320,425,.753,201,260,461,205,63,24,203,224,955
1984,Bob McAdoo*,C,32,LAL,70,0,1456,352,748,.471,0,5,.000,352,743,.474,.471,212,264,.803,82,207,289,74,42,50,127,182,916
1984,Rodney McCray,SF,22,HOU,79,36,2081,335,672,.499,1,4,.250,334,668,.500,.499,182,249,.731,173,277,450,176,53,54,120,205,853
1984,Scooter McCray,PF,23,SEA,47,6,520,47,121,.388,0,0,,47,121,.388,.388,35,50,.700,45,70,115,44,11,19,34,73,129
1984,Hank McDowell,PF,24,SDC,57,0,611,85,197,.431,0,3,.000,85,194,.438,.431,38,56,.679,63,92,155,37,14,2,49,77,208
1984,Mike McGee,SF,24,LAL,77,45,1425,347,584,.594,2,12,.167,345,572,.603,.596,61,113,.540,117,76,193,81,49,6,111,176,757
1984,Kevin McHale*,PF,26,BOS,82,10,2577,587,1055,.556,1,3,.333,586,1052,.557,.557,336,439,.765,208,402,610,104,23,126,150,243,1511
1984,Kevin McKenna,SG,25,IND,61,13,923,152,371,.410,3,17,.176,149,354,.421,.414,80,98,.816,30,65,95,114,46,5,62,133,387
1984,Billy McKinney,PG,28,SDC,80,0,843,136,305,.446,0,2,.000,136,303,.449,.446,39,46,.848,7,47,54,161,27,0,48,84,311
1984,Tom McMillen,C,31,WSB,62,5,1294,222,447,.497,1,6,.167,221,441,.501,.498,127,156,.814,64,135,199,73,14,17,70,162,572
1984,Mark McNamara,C,24,SAS,70,3,1037,157,253,.621,0,0,,157,253,.621,.621,74,157,.471,137,180,317,31,14,12,89,138,388
1984,Joe Meriweather,C,30,KCK,73,31,1501,193,363,.532,0,0,,193,363,.532,.532,94,123,.764,111,242,353,51,35,61,83,247,480
1984,Larry Micheaux,PF,23,KCK,39,0,332,49,90,.544,0,0,,49,90,.544,.544,21,39,.538,40,73,113,19,21,11,21,46,119
1984,Bob Miller,PF,27,SAS,2,0,8,2,3,.667,0,0,,2,3,.667,.667,0,0,,2,3,5,1,0,1,0,5,4
1984,Mike Mitchell,SF,28,SAS,79,79,2853,779,1597,.488,6,14,.429,773,1583,.488,.490,275,353,.779,188,382,570,93,62,73,141,251,1839
1984,Paul Mokeski,C,27,MIL,68,4,838,102,213,.479,1,3,.333,101,210,.481,.481,50,72,.694,51,115,166,44,11,29,44,168,255
1984,Sidney Moncrief*,SG,26,MIL,79,79,3075,560,1125,.498,5,18,.278,555,1107,.501,.500,529,624,.848,215,313,528,358,108,27,217,204,1654
1984,Johnny Moore,PG,25,SAS,59,42,1650,231,518,.446,28,87,.322,203,431,.471,.473,105,139,.755,37,141,178,566,123,20,143,168,595
1984,Larry Nance,PF,24,PHO,82,82,2899,601,1044,.576,0,7,.000,601,1037,.580,.576,249,352,.707,227,451,678,214,86,174,177,274,1451
1984,Swen Nater,C,34,LAL,69,0,829,124,253,.490,0,1,.000,124,252,.492,.490,63,91,.692,81,183,264,27,25,7,68,150,311
1984,Calvin Natt,SF,27,POR,79,74,2638,500,857,.583,2,17,.118,498,840,.593,.585,275,345,.797,166,310,476,179,69,22,166,218,1277
1984,Ed Nealy,PF,23,KCK,71,1,960,63,126,.500,0,0,,63,126,.500,.500,48,60,.800,73,149,222,50,41,9,33,138,174
1984,Kurt Nimphius,C,25,DAL,82,46,2284,272,523,.520,1,4,.250,271,519,.522,.521,101,162,.623,182,331,513,176,41,144,98,283,646
1984,Norm Nixon,PG,28,SDC,82,82,3053,587,1270,.462,11,46,.239,576,1224,.471,.467,206,271,.760,56,147,203,914,94,4,257,180,1391
1984,Audie Norris,C,23,POR,79,1,1157,124,246,.504,0,0,,124,246,.504,.504,104,149,.698,82,175,257,76,30,34,114,231,352
1984,Mike O'Koren,SF,25,NJN,73,25,1191,186,385,.483,5,28,.179,181,357,.507,.490,53,87,.609,71,104,175,95,34,11,75,148,430
1984,Mark Olberding,PF,27,KCK,81,81,2160,249,504,.494,0,1,.000,249,503,.495,.494,261,318,.821,119,326,445,192,50,28,166,291,759
1984,Jawann Oldham,C,26,CHI,64,0,870,110,218,.505,0,0,,110,218,.505,.505,39,66,.591,75,158,233,33,15,76,83,139,259
1984,Louis Orr,SF,25,NYK,78,20,1640,262,572,.458,0,0,,262,572,.458,.458,173,211,.820,101,127,228,61,66,17,95,142,697
1984,Robert Parish*,C,30,BOS,80,79,2867,623,1140,.546,0,0,,623,1140,.546,.546,274,368,.745,243,614,857,139,55,116,184,266,1520
1984,Billy Paultz,C,35,ATL,40,4,486,36,88,.409,0,0,,36,88,.409,.409,17,33,.515,35,78,113,18,8,7,22,57,89
1984,Jim Paxson,SG,26,POR,81,81,2686,680,1322,.514,17,59,.288,663,1263,.525,.521,345,410,.841,68,105,173,251,122,10,142,165,1722
1984,John Paxson,PG,23,SAS,49,0,458,61,137,.445,4,22,.182,57,115,.496,.460,16,26,.615,4,29,33,149,10,2,32,47,142
1984,Roger Phegley,SG,27,TOT,13,0,87,11,35,.314,2,5,.400,9,30,.300,.343,4,4,1.000,2,9,11,11,1,0,6,11,28
1984,Roger Phegley,SG,27,SAS,3,0,11,2,4,.500,1,1,1.000,1,3,.333,.625,2,2,1.000,0,2,2,2,0,0,1,1,7
1984,Roger Phegley,SG,27,DAL,10,0,76,9,31,.290,1,4,.250,8,27,.296,.306,2,2,1.000,2,7,9,9,1,0,5,10,21
1984,Ricky Pierce,SG,24,SDC,69,35,1280,268,570,.470,0,9,.000,268,561,.478,.470,149,173,.861,59,76,135,60,27,13,81,143,685
1984,John Pinone,SF,22,ATL,7,0,65,7,13,.538,0,0,,7,13,.538,.538,6,10,.600,0,10,10,3,2,1,5,11,20
1984,Tom Piotrowski,C,23,POR,18,0,78,12,26,.462,0,0,,12,26,.462,.462,6,6,1.000,6,10,16,5,1,3,6,22,30
1984,Charles Pittman,PF,25,PHO,69,8,989,126,209,.603,0,2,.000,126,207,.609,.603,69,101,.683,76,138,214,70,16,22,81,129,321
1984,Ben Poquette,PF,28,CLE,51,4,858,75,171,.439,1,5,.200,74,166,.446,.442,34,43,.791,57,125,182,49,20,33,28,114,185
1984,Paul Pressey,SG,25,MIL,81,18,1730,276,528,.523,2,9,.222,274,519,.528,.525,120,200,.600,102,180,282,252,86,50,157,241,674
1984,Kurt Rambis,PF,25,LAL,47,31,743,63,113,.558,0,0,,63,113,.558,.558,42,66,.636,82,184,266,34,30,14,56,108,168
1984,Kelvin Ransey,PG,25,NJN,80,50,1937,304,700,.434,7,32,.219,297,668,.445,.439,145,183,.792,28,99,127,483,91,6,141,182,760
1984,Leo Rautins,SF,23,PHI,28,3,196,21,58,.362,0,0,,21,58,.362,.362,6,10,.600,9,24,33,29,9,2,19,31,48
1984,Robert Reid,SF,28,HOU,64,28,1936,406,857,.474,2,8,.250,404,849,.476,.475,81,123,.659,97,244,341,217,88,30,92,243,895
1984,Clint Richardson,SG,27,PHI,69,12,1571,221,473,.467,0,4,.000,221,469,.471,.467,79,103,.767,62,103,165,155,49,23,100,145,521
1984,Micheal Ray Richardson,PG,28,NJN,48,25,1285,243,528,.460,14,58,.241,229,470,.487,.473,76,108,.704,56,116,172,214,103,20,118,156,576
1984,Doc Rivers,PG,22,ATL,81,47,1938,250,541,.462,2,12,.167,248,529,.469,.464,255,325,.785,72,148,220,314,127,30,174,286,757
1984,Anthony Roberts,SF,28,DEN,19,0,197,34,91,.374,0,0,,34,91,.374,.374,13,18,.722,20,31,51,13,5,1,17,43,81
1984,Fred Roberts,PF,23,SAS,79,8,1531,214,399,.536,1,4,.250,213,395,.539,.538,144,172,.837,102,202,304,98,52,38,100,219,573
1984,Rick Robey,C,28,PHO,61,4,856,140,257,.545,1,1,1.000,139,256,.543,.547,61,88,.693,80,118,198,65,20,14,77,120,342
1984,Cliff Robinson,C,23,CLE,73,70,2402,533,1185,.450,1,2,.500,532,1183,.450,.450,234,334,.701,156,597,753,185,51,32,187,195,1301
1984,Truck Robinson,PF,32,NYK,65,63,2135,284,581,.489,0,0,,284,581,.489,.489,133,206,.646,171,374,545,94,43,27,160,217,701
1984,Dave Robisch,C,34,TOT,31,0,340,35,96,.365,0,0,,35,96,.365,.365,22,26,.846,15,43,58,20,3,2,12,36,92
1984,Dave Robisch,C,34,DEN,19,0,141,13,40,.325,0,0,,13,40,.325,.325,11,13,.846,1,20,21,13,0,1,11,13,37
1984,Dave Robisch,C,34,SAS,4,0,37,4,8,.500,0,0,,4,8,.500,.500,0,0,,2,6,8,1,0,0,1,8,8
1984,Dave Robisch,C,34,KCK,8,0,162,18,48,.375,0,0,,18,48,.375,.375,11,13,.846,12,17,29,6,3,1,0,15,47
1984,Tree Rollins,C,28,ATL,77,76,2351,274,529,.518,0,0,,274,529,.518,.518,118,190,.621,200,393,593,62,35,277,101,297,666
1984,Lorenzo Romar,PG,25,TOT,68,9,1022,161,351,.459,4,33,.121,157,318,.494,.464,67,94,.713,21,72,93,193,55,8,63,77,393
1984,Lorenzo Romar,PG,25,GSW,3,0,15,2,5,.400,0,1,.000,2,4,.500,.400,2,4,.500,0,1,1,1,0,0,0,1,6
1984,Lorenzo Romar,PG,25,MIL,65,9,1007,159,346,.460,4,32,.125,155,314,.494,.465,65,90,.722,21,71,92,192,55,8,63,76,387
1984,Dan Roundfield,PF,30,ATL,73,72,2610,503,1038,.485,0,11,.000,503,1027,.490,.485,374,486,.770,206,515,721,184,61,74,205,221,1380
1984,Jeff Ruland,C,25,WSB,75,75,3082,599,1035,.579,1,7,.143,598,1028,.582,.579,466,636,.733,265,657,922,296,68,72,342,285,1665
1984,Walker Russell,PG,23,DET,16,0,119,14,42,.333,1,2,.500,13,40,.325,.345,12,13,.923,6,13,19,22,4,0,9,25,41
1984,Ralph Sampson*,C,23,HOU,82,82,2693,716,1369,.523,1,4,.250,715,1365,.524,.523,287,434,.661,293,620,913,163,70,197,294,339,1720
1984,Mike Sanders,SF,23,PHO,50,0,586,97,203,.478,0,0,,97,203,.478,.478,29,42,.690,40,63,103,44,23,12,44,101,223
1984,DeWayne Scales,PF,25,WSB,2,0,13,3,5,.600,0,0,,3,5,.600,.600,0,2,.000,0,3,3,0,1,0,2,1,6
1984,Danny Schayes,C,24,DEN,82,15,1420,183,371,.493,0,2,.000,183,369,.496,.493,215,272,.790,145,288,433,91,32,60,119,308,581
1984,Alvin Scott,SF,28,PHO,65,5,735,55,124,.444,1,2,.500,54,122,.443,.448,56,72,.778,29,71,100,48,19,20,42,85,167
1984,Byron Scott,SG,22,LAL,74,49,1637,334,690,.484,8,34,.235,326,656,.497,.490,112,139,.806,50,114,164,177,81,19,116,174,788
1984,Lonnie Shelton,PF,28,CLE,79,78,2101,371,779,.476,1,5,.200,370,774,.478,.477,107,140,.764,140,241,381,179,76,55,165,279,850
1984,Purvis Short,SF,26,GSW,79,76,2945,714,1509,.473,22,72,.306,692,1437,.482,.480,353,445,.793,184,254,438,246,103,11,228,252,1803
1984,Jerry Sichting,PG,27,IND,80,80,2497,397,746,.532,6,20,.300,391,726,.539,.536,117,135,.867,44,127,171,457,90,8,144,179,917
1984,Jack Sikma*,C,28,SEA,82,82,2993,576,1155,.499,0,2,.000,576,1153,.500,.499,411,480,.856,225,686,911,327,95,92,236,301,1563
1984,Derek Smith,SG,22,SDC,61,20,1297,238,436,.546,1,6,.167,237,430,.551,.547,123,163,.755,54,116,170,82,33,22,78,165,600
1984,Larry Smith,PF,26,GSW,75,63,2091,244,436,.560,0,0,,244,436,.560,.560,94,168,.560,282,390,672,72,61,22,124,274,582
1984,Ricky Sobers,SG,31,WSB,81,81,2624,508,1115,.456,29,111,.261,479,1004,.477,.469,221,264,.837,51,128,179,377,117,17,222,278,1266
1984,Jim Spanarkel,SG,26,DAL,7,0,54,7,16,.438,1,2,.500,6,14,.429,.469,9,13,.692,5,2,7,5,6,0,4,8,24
1984,Rory Sparrow,PG,25,NYK,79,74,2436,350,738,.474,10,39,.256,340,699,.486,.481,108,131,.824,48,141,189,539,100,8,210,230,818
1984,Larry Spriggs,SF,24,LAL,38,0,363,44,82,.537,0,2,.000,44,80,.550,.537,36,50,.720,16,45,61,30,12,4,34,55,124
1984,Brook Steppe,SG,24,IND,61,13,857,148,314,.471,0,3,.000,148,311,.476,.471,134,161,.832,43,79,122,79,34,6,83,93,430
1984,Steve Stipanovich,C,23,IND,81,73,2426,392,816,.480,3,16,.188,389,800,.486,.482,183,243,.753,116,446,562,170,73,67,161,303,970
1984,Jon Sundvold,PG,22,SEA,73,2,1284,217,488,.445,9,37,.243,208,451,.461,.454,64,72,.889,23,68,91,239,29,1,81,81,507
1984,Dane Suttle,SG,22,KCK,40,1,469,109,214,.509,0,3,.000,109,211,.517,.509,40,47,.851,21,25,46,46,20,0,32,46,258
1984,Terry Teagle,SG,23,HOU,68,0,616,148,315,.470,7,27,.259,141,288,.490,.481,37,44,.841,28,50,78,63,13,4,62,81,340
1984,Reggie Theus,PG,26,TOT,61,35,1498,262,625,.419,7,42,.167,255,583,.437,.425,214,281,.762,50,79,129,352,50,12,156,171,745
1984,Reggie Theus,PG,26,CHI,31,5,601,92,237,.388,3,15,.200,89,222,.401,.395,84,108,.778,21,25,46,142,21,3,59,78,271
1984,Reggie Theus,PG,26,KCK,30,30,897,170,388,.438,4,27,.148,166,361,.460,.443,130,173,.751,29,54,83,210,29,9,97,93,474
1984,David Thirdkill,SF,23,DET,46,0,291,31,72,.431,0,1,.000,31,71,.437,.431,15,31,.484,9,22,31,27,10,3,19,44,77
1984,Isiah Thomas*,PG,22,DET,82,82,3007,669,1448,.462,22,65,.338,647,1383,.468,.470,388,529,.733,103,224,327,914,204,33,307,324,1748
1984,Jim Thomas,SG,23,IND,72,15,1219,187,403,.464,1,11,.091,186,392,.474,.465,80,110,.727,59,90,149,130,60,6,69,115,455
1984,David Thompson*,SG,29,SEA,19,0,349,89,165,.539,0,1,.000,89,164,.543,.539,62,73,.849,18,26,44,13,10,13,27,30,240
1984,LaSalle Thompson,C,22,KCK,80,38,1915,333,637,.523,0,0,,333,637,.523,.523,160,223,.717,260,449,709,86,71,145,168,327,826
1984,Mychal Thompson,C,29,POR,79,74,2648,487,929,.524,0,2,.000,487,927,.525,.524,266,399,.667,235,453,688,308,84,108,235,237,1240
1984,Paul Thompson,SF,22,CLE,82,10,1731,309,662,.467,9,39,.231,300,623,.482,.474,115,149,.772,120,192,312,122,70,37,73,192,742
1984,Sedale Threatt,PG,22,PHI,45,0,464,62,148,.419,1,8,.125,61,140,.436,.422,23,28,.821,17,23,40,41,13,2,33,65,148
1984,Darren Tillis,C,23,GSW,72,1,730,108,254,.425,0,2,.000,108,252,.429,.425,41,63,.651,75,109,184,24,12,60,51,176,257
1984,Ray Tolbert,PF,25,DET,49,0,475,64,121,.529,0,1,.000,64,120,.533,.529,23,45,.511,45,53,98,26,12,20,26,88,151
1984,Andrew Toney,SG,26,PHI,78,72,2556,593,1125,.527,12,38,.316,581,1087,.534,.532,390,465,.839,57,136,193,373,70,23,297,251,1588
1984,Linton Townes,SF,24,TOT,4,0,19,4,8,.500,0,0,,4,8,.500,.500,0,0,,0,1,1,1,1,2,1,4,8
1984,Linton Townes,SF,24,MIL,2,0,2,1,1,1.000,0,0,,1,1,1.000,1.000,0,0,,0,0,0,0,0,0,0,1,2
1984,Linton Townes,SF,24,SDC,2,0,17,3,7,.429,0,0,,3,7,.429,.429,0,0,,0,1,1,1,1,2,1,3,6
1984,Kelly Tripucka,SF,24,DET,76,75,2493,595,1296,.459,2,17,.118,593,1279,.464,.460,426,523,.815,119,187,306,228,65,17,190,190,1618
1984,Trent Tucker,SG,24,NYK,63,21,1228,225,450,.500,6,16,.375,219,434,.505,.507,25,33,.758,43,87,130,138,63,8,54,124,481
1984,Elston Turner,SF,24,DAL,47,1,536,54,150,.360,1,9,.111,53,141,.376,.363,28,34,.824,42,51,93,59,26,0,29,40,137
1984,Terry Tyler,SF,27,DET,82,7,1602,313,691,.453,2,13,.154,311,678,.459,.454,94,132,.712,104,181,285,76,63,59,78,151,722
1984,Darnell Valentine,PG,24,POR,68,60,1893,251,561,.447,0,3,.000,251,558,.450,.447,194,246,.789,49,78,127,395,107,6,149,179,696
1984,Kiki Vandeweghe,PF,25,DEN,78,71,2734,895,1603,.558,11,30,.367,884,1573,.562,.562,494,580,.852,84,289,373,238,53,50,156,187,2295
1984,Pete Verhoeven,PF,24,POR,43,0,327,50,100,.500,0,1,.000,50,99,.505,.500,17,25,.680,27,34,61,20,22,11,21,75,117
1984,Jay Vincent,SF,24,DAL,61,5,1421,252,579,.435,0,1,.000,252,578,.436,.435,168,215,.781,81,166,247,114,30,10,113,159,672
1984,Danny Vranes,SF,25,SEA,80,72,2174,258,495,.521,0,1,.000,258,494,.522,.521,153,236,.648,150,245,395,132,51,54,121,263,669
1984,Granville Waiters,C,23,IND,78,8,1040,123,238,.517,0,1,.000,123,237,.519,.517,31,51,.608,64,163,227,60,24,85,65,164,277
1984,Darrell Walker,PG,22,NYK,82,0,1324,216,518,.417,4,15,.267,212,503,.421,.421,208,263,.791,74,93,167,284,127,15,194,202,644
1984,Foots Walker,PG,32,NJN,34,0,378,32,90,.356,2,5,.400,30,85,.353,.367,24,27,.889,8,23,31,81,20,3,31,37,90
1984,Wally Walker,SF,29,HOU,58,18,612,118,241,.490,2,6,.333,116,235,.494,.494,6,18,.333,26,66,92,55,17,4,33,65,244
1984,Bill Walton*,C,31,SDC,55,46,1476,288,518,.556,0,2,.000,288,516,.558,.556,92,154,.597,132,345,477,183,45,88,177,153,668
1984,Bryan Warrick,PG,24,WSB,32,0,254,27,66,.409,1,3,.333,26,63,.413,.417,8,16,.500,5,17,22,43,9,3,20,37,63
1984,Marvin Webster,C,31,NYK,76,5,1290,112,239,.469,0,0,,112,239,.469,.469,66,117,.564,146,220,366,53,34,100,85,187,290
1984,Scott Wedman,SF,31,BOS,68,5,916,148,333,.444,2,13,.154,146,320,.456,.447,29,35,.829,41,98,139,67,27,7,43,107,327
1984,Brant Weidner,PF,23,SAS,8,0,38,2,9,.222,0,0,,2,9,.222,.222,4,4,1.000,4,7,11,0,0,2,2,5,8
1984,Mark West,C,23,DAL,34,0,202,15,42,.357,0,0,,15,42,.357,.357,7,22,.318,19,27,46,13,1,15,12,55,37
1984,Paul Westphal*,SG,33,PHO,59,2,865,144,313,.460,7,26,.269,137,287,.477,.471,117,142,.824,8,35,43,148,41,6,77,69,412
1984,Ennis Whatley,PG,21,CHI,80,73,2159,261,556,.469,0,2,.000,261,554,.471,.469,146,200,.730,63,134,197,662,119,17,268,223,668
1984,Rory White,SF,24,TOT,36,2,372,80,170,.471,0,0,,80,170,.471,.471,26,47,.553,37,37,74,15,15,3,24,31,186
1984,Rory White,SF,24,PHO,22,2,308,69,144,.479,0,0,,69,144,.479,.479,24,42,.571,30,32,62,14,13,2,18,25,162
1984,Rory White,SF,24,MIL,8,0,45,7,17,.412,0,0,,7,17,.412,.412,2,5,.400,5,3,8,1,2,1,5,3,16
1984,Rory White,SF,24,SDC,6,0,19,4,9,.444,0,0,,4,9,.444,.444,0,0,,2,2,4,0,0,0,1,3,8
1984,Jerome Whitehead,C,27,SDC,70,1,921,144,294,.490,0,0,,144,294,.490,.490,88,107,.822,94,151,245,19,17,12,59,159,376
1984,Mitchell Wiggins,SG,24,CHI,82,40,2123,399,890,.448,7,29,.241,392,861,.455,.452,213,287,.742,138,190,328,187,106,11,139,278,1018
1984,Jamaal Wilkes*,SF,30,LAL,75,74,2507,542,1055,.514,2,8,.250,540,1047,.516,.515,208,280,.743,130,210,340,214,72,41,137,205,1294
1984,Dominique Wilkins*,SF,24,ATL,81,81,2961,684,1429,.479,0,11,.000,684,1418,.482,.479,382,496,.770,254,328,582,126,117,87,215,197,1750
1984,Jeff Wilkins,C,28,UTA,81,1,1734,249,520,.479,0,3,.000,249,517,.482,.479,134,182,.736,109,346,455,73,27,42,109,205,632
1984,Buck Williams,PF,23,NJN,81,81,3003,495,926,.535,0,4,.000,495,922,.537,.535,284,498,.570,355,645,1000,130,81,125,237,298,1274
1984,Gus Williams,PG,30,SEA,80,80,2818,598,1306,.458,4,25,.160,594,1281,.464,.459,297,396,.750,67,137,204,675,189,25,232,151,1497
1984,Herb Williams,C,25,IND,69,53,2279,411,860,.478,0,4,.000,411,856,.480,.478,207,295,.702,154,400,554,215,60,108,207,193,1029
1984,Kevin Williams,SG,22,SAS,19,0,200,25,58,.431,0,1,.000,25,57,.439,.431,25,32,.781,4,9,13,43,8,4,22,42,75
1984,Ray Williams,SG,29,NYK,76,63,2230,418,939,.445,25,81,.309,393,858,.458,.458,263,318,.827,67,200,267,449,162,26,219,274,1124
1984,Rob Williams,PG,22,DEN,79,66,1924,309,671,.461,15,47,.319,294,624,.471,.472,171,209,.818,54,140,194,464,84,5,169,268,804
1984,Sam Williams,PF,24,TOT,77,12,1434,204,431,.473,0,1,.000,204,430,.474,.473,92,140,.657,121,218,339,62,68,106,99,209,500
1984,Sam Williams,PF,24,GSW,7,0,59,11,26,.423,0,0,,11,26,.423,.423,6,7,.857,4,9,13,2,6,3,3,6,28
1984,Sam Williams,PF,24,PHI,70,12,1375,193,405,.477,0,1,.000,193,404,.478,.477,86,133,.647,117,209,326,60,62,103,96,203,472
1984,Sly Williams,SF,26,ATL,13,1,258,34,114,.298,1,9,.111,33,105,.314,.303,36,46,.783,19,31,50,16,14,1,18,33,105
1984,Bill Willoughby,SF,26,NJN,67,2,936,124,258,.481,0,7,.000,124,251,.494,.481,55,63,.873,75,118,193,56,23,24,53,106,303
1984,Michael Wilson,PG,24,WSB,6,0,26,0,2,.000,0,1,.000,0,1,.000,.000,1,2,.500,1,0,1,3,0,0,3,5,1
1984,Randy Wittman,SG,24,ATL,78,1,1071,160,318,.503,2,5,.400,158,313,.505,.506,28,46,.609,14,57,71,71,17,0,32,82,350
1984,Al Wood,SG,25,SEA,81,81,2236,467,945,.494,3,21,.143,464,924,.502,.496,223,271,.823,94,181,275,166,64,32,126,207,1160
1984,Mike Woodson,SG,25,KCK,71,12,1838,389,816,.477,2,8,.250,387,808,.479,.478,247,302,.818,62,113,175,175,83,28,115,174,1027
1984,Orlando Woolridge,SF,24,CHI,75,74,2544,570,1086,.525,1,2,.500,569,1084,.525,.525,303,424,.715,130,239,369,136,71,60,188,253,1444
1984,James Worthy*,PF,22,LAL,82,53,2415,495,890,.556,0,6,.000,495,884,.560,.556,195,257,.759,157,358,515,207,77,70,181,244,1185
1985,Kareem Abdul-Jabbar*,C,37,LAL,79,79,2630,723,1207,.599,0,1,.000,723,1206,.600,.599,289,395,.732,162,460,622,249,63,162,197,238,1735
1985,Alvan Adams,PF,30,PHO,82,69,2136,476,915,.520,0,0,,476,915,.520,.520,250,283,.883,153,347,500,308,115,48,197,254,1202
1985,Mark Aguirre,SF,25,DAL,80,79,2699,794,1569,.506,27,85,.318,767,1484,.517,.515,440,580,.759,188,289,477,249,60,24,253,250,2055
1985,Danny Ainge,SG,25,BOS,75,73,2564,419,792,.529,15,56,.268,404,736,.549,.539,118,136,.868,76,192,268,399,122,6,149,228,971
1985,Chuck Aleksinas,C,25,GSW,74,4,1114,161,337,.478,0,1,.000,161,336,.479,.478,55,75,.733,87,183,270,36,15,15,72,171,377
1985,J.J. Anderson,SF,24,UTA,44,0,457,61,149,.409,0,2,.000,61,147,.415,.409,27,45,.600,29,53,82,21,29,9,32,70,149
1985,Ron Anderson,SF,26,CLE,36,7,520,84,195,.431,1,2,.500,83,193,.430,.433,41,50,.820,39,49,88,34,9,7,34,40,210
1985,John Bagley,PG,24,CLE,81,65,2401,338,693,.488,3,26,.115,335,667,.502,.490,125,167,.749,54,237,291,697,129,5,207,132,804
1985,James Bailey,PF,27,NYK,74,28,1297,156,349,.447,0,1,.000,156,348,.448,.447,73,108,.676,122,222,344,39,30,50,100,286,385
1985,Thurl Bailey,PF,23,UTA,80,68,2481,507,1034,.490,1,1,1.000,506,1033,.490,.491,197,234,.842,153,372,525,138,51,105,152,215,1212
1985,Greg Ballard,SF,30,WSB,82,77,2664,469,978,.480,14,46,.304,455,932,.488,.487,120,151,.795,150,381,531,208,100,33,106,221,1072
1985,Gene Banks,SF,25,SAS,82,41,2091,289,493,.586,1,3,.333,288,490,.588,.587,199,257,.774,133,312,445,234,65,13,140,220,778
1985,Ken Bannister,PF,24,NYK,75,50,1404,209,445,.470,0,0,,209,445,.470,.470,91,192,.474,108,222,330,39,38,40,141,279,509
1985,Charles Barkley*,PF,21,PHI,82,60,2347,427,783,.545,1,6,.167,426,777,.548,.546,293,400,.733,266,437,703,155,95,80,209,301,1148
1985,Kent Benson,C,30,DET,72,35,1401,201,397,.506,0,3,.000,201,394,.510,.506,76,94,.809,103,221,324,93,53,44,68,207,478
1985,Larry Bird*,SF,28,BOS,80,77,3161,918,1760,.522,56,131,.427,862,1629,.529,.538,403,457,.882,164,678,842,531,129,98,248,208,2295
1985,Otis Birdsong,SG,29,NJN,56,45,1842,495,968,.511,4,21,.190,491,947,.518,.513,161,259,.622,60,88,148,232,84,7,117,145,1155
1985,Rolando Blackman,SG,25,DAL,81,80,2834,625,1230,.508,6,20,.300,619,1210,.512,.511,342,413,.828,107,193,300,289,61,16,162,96,1598
1985,Cory Blackwell,SF,21,SEA,60,0,551,87,237,.367,0,2,.000,87,235,.370,.367,28,55,.509,42,54,96,26,25,3,44,55,202
1985,Sam Bowie,C,23,POR,76,62,2216,299,557,.537,0,0,,299,557,.537,.537,160,225,.711,207,449,656,215,55,203,172,278,758
1985,Dudley Bradley,SG,27,WSB,73,24,1232,142,299,.475,20,64,.313,122,235,.519,.508,54,79,.684,34,100,134,173,96,21,84,152,358
1985,Mike Bratz,PG,29,GSW,56,6,746,106,250,.424,6,26,.231,100,224,.446,.436,69,82,.841,11,47,58,122,47,4,54,76,287
1985,Randy Breuer,C,24,MIL,78,0,1083,162,317,.511,0,0,,162,317,.511,.511,89,127,.701,92,164,256,40,21,82,63,179,413
1985,Ron Brewer,SG,29,TOT,20,0,326,62,118,.525,0,2,.000,62,116,.534,.525,23,25,.920,9,12,21,17,6,6,9,23,147
1985,Ron Brewer,SG,29,SAS,9,0,81,13,34,.382,0,0,,13,34,.382,.382,7,7,1.000,1,2,3,6,1,1,4,8,33
1985,Ron Brewer,SG,29,NJN,11,0,245,49,84,.583,0,2,.000,49,82,.598,.583,16,18,.889,8,10,18,11,5,5,5,15,114
1985,Frank Brickowski,C,25,SEA,78,9,1115,150,305,.492,0,4,.000,150,301,.498,.492,85,127,.669,76,184,260,100,34,15,100,171,385
1985,Junior Bridgeman,SF,31,LAC,80,15,2042,460,990,.465,14,39,.359,446,951,.469,.472,181,206,.879,55,175,230,171,47,18,116,128,1115
1985,Rickey Brown,C,26,ATL,69,5,814,78,192,.406,0,0,,78,192,.406,.406,39,68,.574,76,147,223,25,19,22,51,117,195
1985,Tony Brown,SF,24,IND,82,26,1586,214,465,.460,0,6,.000,214,459,.466,.460,116,171,.678,146,142,288,159,59,12,116,212,544
1985,Wallace Bryant,C,25,DAL,56,35,860,67,148,.453,0,0,,67,148,.453,.453,30,44,.682,74,167,241,84,21,24,46,110,164
1985,Quinn Buckner,PG,30,BOS,75,6,858,74,193,.383,0,1,.000,74,192,.385,.383,32,50,.640,26,61,87,148,63,2,67,142,180
1985,Steve Burtt,SG,22,GSW,47,0,418,72,188,.383,0,1,.000,72,187,.385,.383,53,77,.688,10,18,28,20,21,4,33,76,197
1985,Don Buse,PG,34,KCK,65,14,939,82,203,.404,31,87,.356,51,116,.440,.480,23,30,.767,21,40,61,203,38,1,45,75,218
1985,Michael Cage,PF,23,LAC,75,41,1610,216,398,.543,0,0,,216,398,.543,.543,101,137,.737,126,266,392,51,41,32,81,164,533
1985,Tony Campbell,SF,22,DET,56,0,625,130,262,.496,0,1,.000,130,261,.498,.496,56,70,.800,41,48,89,24,28,3,69,107,316
1985,Rick Carlisle,SG,25,BOS,38,0,179,26,67,.388,0,2,.000,26,65,.400,.388,15,17,.882,8,13,21,25,3,0,19,21,67
1985,Antoine Carr,PF,23,ATL,62,15,1195,198,375,.528,2,6,.333,196,369,.531,.531,101,128,.789,79,153,232,80,29,78,108,219,499
1985,Kenny Carr,PF,29,POR,48,30,1120,190,363,.523,0,3,.000,190,360,.528,.523,118,164,.720,90,233,323,56,25,17,100,141,498
1985,M.L. Carr,SF,34,BOS,47,0,397,62,149,.416,9,23,.391,53,126,.421,.446,17,17,1.000,21,22,43,24,21,6,24,44,150
1985,Butch Carter,SG,26,NYK,69,11,1279,214,476,.450,11,43,.256,203,433,.469,.461,109,134,.813,36,59,95,167,57,5,109,151,548
1985,Howard Carter,SG,23,DAL,11,0,66,4,23,.174,0,3,.000,4,20,.200,.174,1,1,1.000,1,2,3,4,1,0,8,4,9
1985,Harvey Catchings,C,33,LAC,70,14,1049,72,149,.483,0,1,.000,72,148,.486,.483,59,89,.663,89,173,262,14,15,57,55,162,203
1985,Ron Cavenall,C,25,NYK,53,2,653,28,86,.326,0,0,,28,86,.326,.326,22,39,.564,53,113,166,19,12,42,45,123,78
1985,Tom Chambers,PF,25,SEA,81,60,2923,629,1302,.483,6,22,.273,623,1280,.487,.485,475,571,.832,164,415,579,209,70,57,260,312,1739
1985,Maurice Cheeks*,PG,28,PHI,78,78,2616,422,741,.570,6,26,.231,416,715,.582,.574,175,199,.879,54,163,217,497,169,24,155,184,1025
1985,Carlos Clark,SG,24,BOS,62,3,562,64,152,.421,0,5,.000,64,147,.435,.421,41,53,.774,29,40,69,48,35,2,42,66,169
1985,Don Collins,SG,26,WSB,11,0,91,12,34,.353,0,0,,12,34,.353,.353,8,9,.889,10,9,19,7,7,4,8,5,32
1985,Steve Colter,PG,22,POR,78,22,1462,216,477,.453,26,74,.351,190,403,.471,.480,98,130,.754,40,110,150,243,75,9,112,142,556
1985,Lester Conner,PG,25,GSW,79,49,2258,246,546,.451,4,20,.200,242,526,.460,.454,144,192,.750,87,159,246,369,161,13,138,136,640
1985,Darwin Cook,PG,26,NJN,58,9,1063,212,453,.468,2,23,.087,210,430,.488,.470,47,54,.870,21,71,92,160,74,10,75,96,473
1985,Jeff Cook,PF,28,TOT,72,5,1288,138,279,.495,0,1,.000,138,278,.496,.495,47,64,.734,122,192,314,62,30,23,48,203,323
1985,Jeff Cook,PF,28,CLE,18,3,440,46,105,.438,0,1,.000,46,104,.442,.438,17,27,.630,41,63,104,23,5,9,16,53,109
1985,Jeff Cook,PF,28,SAS,54,2,848,92,174,.529,0,0,,92,174,.529,.529,30,37,.811,81,129,210,39,25,14,32,150,214
1985,Joe Cooper,C,27,SEA,3,1,45,7,15,.467,0,0,,7,15,.467,.467,3,6,.500,3,6,9,2,2,1,0,7,17
1985,Michael Cooper,SG,28,LAL,82,20,2189,276,593,.465,35,123,.285,241,470,.513,.495,115,133,.865,56,199,255,429,93,49,156,208,702
1985,Wayne Cooper,C,28,DEN,80,78,2031,404,856,.472,0,2,.000,404,854,.473,.472,161,235,.685,229,402,631,86,28,197,149,304,969
1985,Dave Corzine,C,28,CHI,82,50,2062,276,568,.486,0,1,.000,276,567,.487,.486,149,200,.745,130,292,422,140,32,64,124,189,701
1985,Charlie Criss,PG,36,ATL,4,2,115,7,17,.412,0,2,.000,7,15,.467,.412,4,6,.667,2,12,14,22,3,0,11,5,18
1985,Pat Cummings,C,28,NYK,63,63,2069,410,797,.514,0,4,.000,410,793,.517,.514,177,227,.780,139,379,518,109,50,17,166,247,997
1985,Terry Cummings,PF,23,MIL,79,78,2722,759,1532,.495,0,1,.000,759,1531,.496,.495,343,463,.741,244,472,716,228,117,67,190,264,1861
1985,Earl Cureton,C,27,DET,81,1,1642,207,428,.484,0,3,.000,207,425,.487,.484,82,144,.569,169,250,419,83,56,42,114,216,496
1985,Quintin Dailey,SG,24,CHI,79,0,2101,525,1111,.473,7,30,.233,518,1081,.479,.476,205,251,.817,57,151,208,191,71,5,154,192,1262
1985,Adrian Dantley*,SF,29,UTA,55,46,1971,512,964,.531,0,0,,512,964,.531,.531,438,545,.804,148,175,323,186,57,8,171,133,1462
1985,Brad Davis,PG,29,DAL,82,82,2539,310,614,.505,47,115,.409,263,499,.527,.543,158,178,.888,39,154,193,581,91,10,123,219,825
1985,Charles Davis,SF,26,TOT,61,2,774,153,356,.430,1,10,.100,152,346,.439,.431,51,62,.823,59,94,153,51,22,5,54,113,358
1985,Charles Davis,SF,26,WSB,4,0,28,2,10,.200,0,0,,2,10,.200,.200,3,4,.750,2,2,4,1,1,0,2,3,7
1985,Charles Davis,SF,26,MIL,57,2,746,151,346,.436,1,10,.100,150,336,.446,.438,48,58,.828,57,92,149,50,21,5,52,110,351
1985,Johnny Davis,PG,29,CLE,76,30,1920,337,791,.426,12,46,.261,325,745,.436,.434,255,300,.850,35,84,119,426,43,4,152,136,941
1985,Walter Davis,SG,30,PHO,23,9,570,139,309,.450,3,10,.300,136,299,.455,.455,64,73,.877,6,29,35,98,18,0,50,42,345
1985,Darryl Dawkins,C,28,NJN,39,30,972,192,339,.566,0,1,.000,192,338,.568,.566,143,201,.711,55,126,181,45,14,35,93,171,527
1985,Darren Daye,SF,24,WSB,80,8,1573,258,504,.512,1,7,.143,257,497,.517,.513,178,249,.715,93,179,272,240,53,19,134,164,695
1985,James Donaldson,C,27,LAC,82,58,2392,351,551,.637,0,0,,351,551,.637,.637,227,303,.749,168,500,668,48,28,130,206,217,929
1985,John Drew,SF,30,UTA,19,16,463,107,260,.412,0,4,.000,107,256,.418,.412,94,122,.770,36,46,82,35,22,2,42,65,308
1985,Larry Drew,PG,26,KCK,72,66,2373,457,913,.501,7,28,.250,450,885,.508,.504,154,194,.794,39,125,164,484,93,8,179,147,1075
1985,Clyde Drexler*,SG,22,POR,80,43,2555,573,1161,.494,8,37,.216,565,1124,.503,.497,223,294,.759,217,259,476,441,177,68,223,265,1377
1985,Mike Dunleavy,PG,30,MIL,19,19,433,64,135,.474,16,47,.340,48,88,.545,.533,25,29,.862,6,25,31,85,15,3,40,55,169
1985,T.R. Dunn,SG,29,DEN,81,81,2290,175,358,.489,0,2,.000,175,356,.492,.489,84,116,.724,169,216,385,153,140,14,65,213,434
1985,Devin Durrant,SF,24,IND,59,8,756,114,274,.416,0,3,.000,114,271,.421,.416,72,102,.706,49,75,124,80,19,10,77,106,300
1985,Mark Eaton,C,28,UTA,82,82,2813,302,673,.449,0,0,,302,673,.449,.449,190,267,.712,207,720,927,124,36,456,206,312,794
1985,Jerry Eaves,PG,25,ATL,3,0,37,3,6,.500,0,0,,3,6,.500,.500,5,6,.833,0,0,0,4,0,0,4,6,11
1985,Kenton Edelin,SF,22,IND,10,1,143,4,13,.308,0,0,,4,13,.308,.308,3,8,.375,8,18,26,10,5,4,3,39,11
1985,Franklin Edwards,PG,25,LAC,16,0,198,36,66,.545,0,0,,36,66,.545,.545,19,24,.792,3,11,14,38,17,0,17,10,91
1985,James Edwards,C,29,PHO,70,58,1787,384,766,.501,0,3,.000,384,763,.503,.501,276,370,.746,95,292,387,153,26,52,162,237,1044
1985,Craig Ehlo,SG,23,HOU,45,0,189,34,69,.493,0,3,.000,34,66,.515,.493,19,30,.633,8,17,25,26,11,3,22,26,87
1985,Dale Ellis,SF,24,DAL,72,4,1314,274,603,.454,42,109,.385,232,494,.470,.489,77,104,.740,100,138,238,56,46,7,58,131,667
1985,Chris Engler,C,25,TOT,11,0,82,8,20,.400,0,0,,8,20,.400,.400,5,9,.556,12,18,30,0,2,5,2,5,21
1985,Chris Engler,C,25,NJN,7,0,76,7,16,.438,0,0,,7,16,.438,.438,5,9,.556,10,17,27,0,2,4,1,4,19
1985,Chris Engler,C,25,CHI,3,0,3,1,2,.500,0,0,,1,2,.500,.500,0,0,,1,1,2,0,0,0,1,1,2
1985,Chris Engler,C,25,MIL,1,0,3,0,2,.000,0,0,,0,2,.000,.000,0,0,,1,0,1,0,0,1,0,0,0
1985,Alex English*,SF,31,DEN,81,81,2924,939,1812,.518,1,5,.200,938,1807,.519,.518,383,462,.829,203,255,458,344,101,46,251,259,2262
1985,Julius Erving*,SF,34,PHI,78,78,2535,610,1236,.494,3,14,.214,607,1222,.497,.495,338,442,.765,172,242,414,233,135,109,208,199,1561
1985,Mike Evans,SG,29,DEN,81,0,1437,323,661,.489,57,157,.363,266,504,.528,.532,113,131,.863,26,93,119,231,65,12,130,174,816
1985,Kenny Fields,SF,22,MIL,51,1,535,84,191,.440,0,0,,84,191,.440,.440,27,36,.750,41,43,84,38,9,10,32,84,195
1985,Vern Fleming,PG,22,IND,80,65,2486,433,922,.470,0,4,.000,433,918,.472,.470,260,339,.767,148,175,323,247,99,8,197,232,1126
1985,Sleepy Floyd,SG,24,GSW,82,82,2873,610,1372,.445,42,143,.294,568,1229,.462,.460,336,415,.810,62,140,202,406,134,41,251,226,1598
1985,Phil Ford,PG,28,HOU,25,1,290,14,47,.298,0,4,.000,14,43,.326,.298,16,18,.889,3,24,27,61,6,1,17,33,44
1985,Rod Foster,PG,24,PHO,79,1,1318,286,636,.450,41,126,.325,245,510,.480,.482,83,110,.755,27,53,80,186,61,0,117,171,696
1985,World B. Free,SG,31,CLE,71,50,2249,609,1328,.459,71,193,.368,538,1135,.474,.485,308,411,.749,61,150,211,320,75,16,139,163,1597
1985,Bill Garnett,PF,24,IND,65,13,1123,149,310,.481,0,2,.000,149,308,.484,.481,120,174,.690,98,188,286,67,28,15,92,196,418
1985,George Gervin*,SG,32,SAS,72,69,2091,600,1182,.508,0,10,.000,600,1172,.512,.508,324,384,.844,79,155,234,178,66,48,198,208,1524
1985,Artis Gilmore*,C,35,SAS,81,81,2756,532,854,.623,0,2,.000,532,852,.624,.623,484,646,.749,231,615,846,131,40,173,241,306,1548
1985,Mike Glenn,SG,29,ATL,60,5,1126,228,388,.588,0,2,.000,228,386,.591,.588,62,76,.816,20,61,81,122,27,0,55,74,518
1985,Mike Gminski,C,25,NJN,81,54,2418,380,818,.465,0,1,.000,380,817,.465,.465,276,328,.841,229,404,633,158,38,92,136,135,1036
1985,Lancaster Gordon,SG,22,LAC,63,1,682,110,287,.383,2,9,.222,108,278,.388,.387,37,49,.755,26,35,61,88,33,6,69,61,259
1985,Stewart Granger,PG,23,ATL,9,1,92,6,17,.353,0,1,.000,6,16,.375,.353,4,8,.500,1,5,6,12,2,0,12,13,16
1985,Butch Graves,SG,23,CLE,4,0,11,2,6,.333,0,1,.000,2,5,.400,.333,1,5,.200,0,2,2,1,1,0,1,4,5
1985,Stuart Gray,C,21,IND,52,0,391,35,92,.380,0,0,,35,92,.380,.380,32,47,.681,29,94,123,15,9,14,51,82,102
1985,Rickey Green,PG,30,UTA,77,77,2431,381,798,.477,6,20,.300,375,778,.482,.481,232,267,.869,37,152,189,597,132,3,177,131,1000
1985,Sidney Green,PF,24,CHI,48,1,740,108,250,.432,0,4,.000,108,246,.439,.432,79,98,.806,72,174,246,29,11,14,68,102,295
1985,Dave Greenwood,PF,27,CHI,61,28,1523,152,332,.458,0,1,.000,152,331,.459,.458,67,94,.713,108,280,388,78,34,18,63,190,371
1985,Kevin Grevey,SF,31,MIL,78,6,1182,190,424,.448,8,33,.242,182,391,.465,.458,88,107,.822,27,76,103,94,30,2,55,85,476
1985,Darrell Griffith,SG,26,UTA,78,78,2776,728,1593,.457,92,257,.358,636,1336,.476,.486,216,298,.725,124,220,344,243,133,30,247,178,1764
1985,Ernie Grunfeld,SF,29,NYK,69,0,1061,188,384,.490,2,8,.250,186,376,.495,.492,77,104,.740,41,110,151,105,50,7,40,129,455
1985,Bob Hansen,SG,24,UTA,54,4,646,110,225,.489,1,7,.143,109,218,.500,.491,40,72,.556,20,50,70,75,25,1,49,88,261
1985,Bill Hanzlik,SF,27,DEN,80,1,1673,220,522,.421,1,15,.067,219,507,.432,.422,180,238,.756,88,119,207,210,84,26,115,291,621
1985,Derek Harper,PG,23,DAL,82,1,2218,329,633,.520,21,61,.344,308,572,.538,.536,111,154,.721,47,152,199,360,144,37,123,194,790
1985,Scott Hastings,PF,24,ATL,64,1,825,89,188,.473,0,0,,89,188,.473,.473,63,81,.778,59,100,159,46,24,23,50,135,241
1985,Steve Hayes,C,29,PHI,11,0,101,10,18,.556,0,0,,10,18,.556,.556,2,4,.500,11,23,34,1,1,4,2,19,22
1985,Gerald Henderson,PG,29,SEA,79,78,2648,427,891,.479,9,38,.237,418,853,.490,.484,199,255,.780,71,119,190,559,140,9,231,196,1062
1985,Rod Higgins,SF,25,CHI,68,5,942,119,270,.441,10,37,.270,109,233,.468,.459,60,90,.667,55,92,147,73,21,13,49,91,308
1985,Roy Hinson,PF,23,CLE,76,75,2344,465,925,.503,0,3,.000,465,922,.504,.503,271,376,.721,186,410,596,68,51,173,171,311,1201
1985,Craig Hodges,SG,24,MIL,82,63,2496,359,732,.490,47,135,.348,312,597,.523,.523,106,130,.815,74,112,186,349,96,1,135,262,871
1985,Lionel Hollins,PG,31,HOU,80,60,1950,249,540,.461,3,13,.231,246,527,.467,.464,108,136,.794,33,140,173,417,78,10,170,187,609
1985,Michael Holton,SG,23,PHO,74,59,1761,257,576,.446,14,45,.311,243,531,.458,.458,96,118,.814,30,102,132,198,59,6,123,141,624
1985,Phil Hubbard,SF,28,CLE,76,55,2249,415,822,.505,0,4,.000,415,818,.507,.505,371,494,.751,214,265,479,114,81,9,178,258,1201
1985,Jay Humphries,SG,22,PHO,80,39,2062,279,626,.446,4,20,.200,275,606,.454,.449,141,170,.829,32,132,164,350,107,8,167,209,703
1985,Geoff Huston,PG,27,CLE,8,0,93,12,25,.480,0,0,,12,25,.480,.480,2,3,.667,0,1,1,23,0,0,8,8,26
1985,Marc Iavaroni,PF,28,TOT,69,43,1334,162,354,.458,0,4,.000,162,350,.463,.458,87,128,.680,95,209,304,119,35,35,119,217,411
1985,Marc Iavaroni,PF,28,PHI,12,10,156,12,31,.387,0,0,,12,31,.387,.387,6,6,1.000,11,18,29,6,4,3,16,24,30
1985,Marc Iavaroni,PF,28,SAS,57,33,1178,150,323,.464,0,4,.000,150,319,.470,.464,81,122,.664,84,191,275,113,31,32,103,193,381
1985,Dan Issel*,C,36,DEN,77,9,1684,363,791,.459,1,7,.143,362,784,.462,.460,257,319,.806,80,251,331,137,65,31,93,171,984
1985,Ralph Jackson,PG,22,IND,1,0,12,1,3,.333,0,0,,1,3,.333,.333,0,0,,1,0,1,4,2,0,1,1,2
1985,Clemon Johnson,C,28,PHI,58,0,875,117,235,.498,0,1,.000,117,234,.500,.498,36,49,.735,92,129,221,33,15,44,43,112,270
1985,Dennis Johnson*,PG,30,BOS,80,77,2976,493,1066,.462,7,26,.269,486,1040,.467,.466,261,306,.853,91,226,317,543,96,39,212,224,1254
1985,Eddie Johnson,SG,29,ATL,73,66,2367,453,946,.479,22,72,.306,431,874,.493,.490,265,332,.798,38,154,192,566,43,7,244,184,1193
1985,Eddie Johnson,SF,25,KCK,82,81,3029,769,1565,.491,13,54,.241,756,1511,.500,.496,325,373,.871,151,256,407,273,83,22,225,237,1876
1985,Frank Johnson,PG,26,WSB,46,1,925,175,358,.489,6,17,.353,169,341,.496,.497,72,96,.750,23,40,63,143,43,3,59,72,428
1985,George Johnson,C,36,NJN,65,0,800,42,79,.532,1,1,1.000,41,78,.526,.538,22,27,.815,74,111,185,22,19,78,39,151,107
1985,George Johnson,SF,28,PHI,55,3,756,107,263,.407,1,10,.100,106,253,.419,.409,49,56,.875,48,116,164,38,31,16,49,99,264
1985,Magic Johnson*,PG,25,LAL,77,77,2781,504,899,.561,7,37,.189,497,862,.577,.565,391,464,.843,90,386,476,968,113,25,305,155,1406
1985,Marques Johnson,SF,28,LAC,72,68,2448,494,1094,.452,3,13,.231,491,1081,.454,.453,190,260,.731,188,240,428,248,72,30,176,193,1181
1985,Mickey Johnson,PF,32,GSW,66,9,1565,304,714,.426,7,30,.233,297,684,.434,.431,260,316,.823,149,247,396,149,70,35,142,221,875
1985,Steve Johnson,C,27,CHI,74,54,1659,281,516,.545,0,3,.000,281,513,.548,.545,181,252,.718,146,291,437,64,37,62,151,265,743
1985,Vinnie Johnson,SG,28,DET,82,16,2093,428,942,.454,5,27,.185,423,915,.462,.457,190,247,.769,134,118,252,325,71,20,135,205,1051
1985,Bobby Jones*,PF,33,PHI,80,8,1633,207,385,.538,0,4,.000,207,381,.543,.538,186,216,.861,105,192,297,155,84,50,118,183,600
1985,Caldwell Jones,C,34,CHI,42,32,885,53,115,.461,0,2,.000,53,113,.469,.461,36,47,.766,49,162,211,34,12,31,40,125,142
1985,Charles Jones,C,23,PHO,78,14,1565,236,454,.520,0,4,.000,236,450,.524,.520,182,281,.648,139,255,394,128,45,61,143,149,654
1985,Charles Jones,C-PF,27,TOT,31,4,667,67,127,.528,0,0,,67,127,.528,.528,40,58,.690,71,113,184,26,22,79,25,107,174
1985,Charles Jones,PF,27,CHI,3,0,29,2,4,.500,0,0,,2,4,.500,.500,4,6,.667,2,4,6,1,0,5,4,6,8
1985,Charles Jones,C,27,WSB,28,4,638,65,123,.528,0,0,,65,123,.528,.528,36,52,.692,69,109,178,25,22,74,21,101,166
1985,Earl Jones,C,24,LAL,2,0,7,0,1,.000,0,0,,0,1,.000,.000,0,0,,0,0,0,0,0,0,1,0,0
1985,Edgar Jones,PF,28,TOT,44,5,769,130,275,.473,0,4,.000,130,271,.480,.473,82,111,.739,50,121,171,29,20,29,61,123,342
1985,Edgar Jones,PF,28,SAS,18,1,322,44,91,.484,0,1,.000,44,90,.489,.484,41,51,.804,16,46,62,18,9,18,28,52,129
1985,Edgar Jones,PF,28,CLE,26,4,447,86,184,.467,0,3,.000,86,181,.475,.467,41,60,.683,34,75,109,11,11,11,33,71,213
1985,Major Jones,PF,31,DET,47,0,418,48,87,.552,0,0,,48,87,.552,.552,33,51,.647,48,80,128,15,9,14,35,58,129
1985,Ozell Jones,C,24,SAS,67,6,888,106,180,.589,0,1,.000,106,179,.592,.589,33,83,.398,65,173,238,56,30,57,61,139,245
1985,Michael Jordan*,SG,21,CHI,82,82,3144,837,1625,.515,9,52,.173,828,1573,.526,.518,630,746,.845,167,367,534,481,196,69,291,285,2313
1985,Rich Kelley,C,31,UTA,77,34,1276,103,216,.477,0,2,.000,103,214,.481,.477,84,112,.750,118,232,350,120,42,30,124,227,290
1985,Clark Kellogg,PF,23,IND,77,65,2449,562,1112,.505,7,14,.500,555,1098,.505,.509,301,396,.760,224,500,724,244,86,26,231,247,1432
1985,Greg Kelser,SF,27,IND,10,0,114,21,53,.396,0,1,.000,21,52,.404,.396,20,28,.714,6,13,19,13,7,0,12,16,62
1985,Jerome Kersey,SF,22,POR,77,0,958,178,372,.478,0,3,.000,178,369,.482,.478,117,181,.646,95,111,206,63,49,29,66,147,473
1985,Albert King,SF,25,NJN,42,7,860,226,460,.491,0,8,.000,226,452,.500,.491,85,104,.817,70,89,159,58,41,9,65,110,537
1985,Bernard King*,SF,28,NYK,55,55,2063,691,1303,.530,1,10,.100,690,1293,.534,.531,426,552,.772,114,203,317,204,71,15,204,191,1809
1985,Reggie King,SF,27,SEA,60,5,860,63,149,.423,0,0,,63,149,.423,.423,41,59,.695,44,78,122,53,28,11,42,74,167
1985,Greg Kite,C,23,BOS,55,4,424,33,88,.375,0,0,,33,88,.375,.375,22,32,.688,38,51,89,17,3,10,29,84,88
1985,Billy Knight,SF-SG,32,TOT,68,1,800,156,354,.441,11,25,.440,145,329,.441,.456,64,73,.877,50,68,118,80,16,2,70,62,387
1985,Billy Knight,SG,32,KCK,16,0,189,31,69,.449,1,1,1.000,30,68,.441,.457,13,16,.813,10,12,22,21,2,1,13,14,76
1985,Billy Knight,SF,32,SAS,52,1,611,125,285,.439,10,24,.417,115,261,.441,.456,51,57,.895,40,56,96,59,14,1,57,48,311
1985,Joe Kopicki,PF,24,DEN,42,0,308,50,95,.526,2,3,.667,48,92,.522,.537,43,54,.796,29,57,86,29,13,1,28,58,145
1985,Mitch Kupchak,PF,30,LAL,58,3,716,123,244,.504,0,0,,123,244,.504,.504,60,91,.659,68,116,184,21,19,20,48,104,306
1985,Tom LaGarde,C,29,NJN,1,0,8,0,1,.000,0,0,,0,1,.000,.000,1,2,.500,1,1,2,0,0,0,1,2,1
1985,Bill Laimbeer,C,27,DET,82,82,2892,595,1177,.506,4,18,.222,591,1159,.510,.507,244,306,.797,295,718,1013,154,69,71,129,308,1438
1985,Allen Leavell,PG,27,HOU,42,0,536,88,209,.421,8,37,.216,80,172,.465,.440,44,57,.772,8,29,37,102,23,4,51,61,228
1985,Ronnie Lester,PG,26,LAL,32,1,278,34,82,.415,0,1,.000,34,81,.420,.415,21,31,.677,4,22,26,80,15,3,32,25,89
1985,Fat Lever,PG,24,DEN,82,82,2559,424,985,.430,6,24,.250,418,961,.435,.434,197,256,.770,147,264,411,613,202,30,203,226,1051
1985,Cliff Levingston,PF,24,ATL,74,53,2017,291,552,.527,0,2,.000,291,550,.529,.527,145,222,.653,230,336,566,104,70,69,133,231,727
1985,Alton Lister,C,26,MIL,81,80,2091,322,598,.538,0,1,.000,322,597,.539,.538,154,262,.588,219,428,647,127,49,167,183,287,798
1985,Lewis Lloyd,SG,25,HOU,82,58,2128,457,869,.526,2,8,.250,455,861,.528,.527,161,220,.732,98,133,231,280,73,28,177,196,1077
1985,John Long,SG,28,DET,66,55,1820,431,885,.487,5,15,.333,426,870,.490,.490,106,123,.862,81,109,190,130,71,14,98,139,973
1985,Sidney Lowe,PG,25,TOT,21,0,190,10,27,.370,0,1,.000,10,26,.385,.370,8,8,1.000,4,12,16,50,11,0,13,28,28
1985,Sidney Lowe,PG,25,DET,6,0,31,2,7,.286,0,0,,2,7,.286,.286,0,0,,0,1,1,8,0,0,2,5,4
1985,Sidney Lowe,PG,25,ATL,15,0,159,8,20,.400,0,1,.000,8,19,.421,.400,8,8,1.000,4,11,15,42,11,0,11,23,24
1985,John Lucas,PG,31,HOU,47,21,1158,206,446,.462,21,66,.318,185,380,.487,.485,103,129,.798,21,64,85,318,62,2,102,78,536
1985,Maurice Lucas,PF,32,PHO,63,22,1670,346,727,.476,0,4,.000,346,723,.479,.476,150,200,.750,138,419,557,145,39,17,151,183,842
1985,Kyle Macy,PG,27,PHO,65,52,2018,282,582,.485,23,85,.271,259,497,.521,.504,127,140,.907,33,146,179,380,85,3,111,128,714
1985,Rick Mahorn,PF,26,WSB,77,63,2072,206,413,.499,0,0,,206,413,.499,.499,71,104,.683,150,458,608,121,59,104,133,308,483
1985,Jeff Malone,SG,23,WSB,76,61,2613,605,1213,.499,15,72,.208,590,1141,.517,.505,211,250,.844,60,146,206,184,52,9,107,176,1436
1985,Moses Malone*,C,29,PHI,79,79,2957,602,1284,.469,0,2,.000,602,1282,.470,.469,737,904,.815,385,646,1031,130,67,123,286,216,1941
1985,Pace Mannion,SF,24,UTA,34,0,190,27,63,.429,0,1,.000,27,62,.435,.429,16,23,.696,12,11,23,27,16,3,18,17,70
1985,Wes Matthews,PG,25,CHI,78,38,1523,191,386,.495,2,16,.125,189,370,.511,.497,59,85,.694,16,51,67,354,73,12,124,133,443
1985,Cedric Maxwell,SF,29,BOS,57,51,1495,201,377,.533,0,2,.000,201,375,.536,.533,231,278,.831,98,144,242,102,36,15,98,140,633
1985,Bob McAdoo*,C,33,LAL,66,0,1254,284,546,.520,0,1,.000,284,545,.521,.520,122,162,.753,79,216,295,67,18,53,95,170,690
1985,Tim McCormick,C,22,SEA,78,27,1584,269,483,.557,0,1,.000,269,482,.558,.557,188,263,.715,146,252,398,78,18,33,114,207,726
1985,Rodney McCray,SF,23,HOU,82,82,3001,476,890,.535,0,6,.000,476,884,.538,.535,231,313,.738,201,338,539,355,90,75,178,215,1183
1985,Scooter McCray,PF,24,SEA,6,0,93,6,10,.600,0,0,,6,10,.600,.600,3,4,.750,6,11,17,7,1,3,10,13,15
1985,Hank McDowell,PF,25,HOU,34,0,132,20,42,.476,0,1,.000,20,41,.488,.476,7,10,.700,7,15,22,9,3,5,8,22,47
1985,Mike McGee,SF,25,LAL,76,3,1170,329,612,.538,22,61,.361,307,551,.557,.556,94,160,.588,97,68,165,71,39,7,81,147,774
1985,Kevin McHale*,PF,27,BOS,79,31,2653,605,1062,.570,0,6,.000,605,1056,.573,.570,355,467,.760,229,483,712,141,28,120,157,234,1565
1985,Kevin McKenna,SG,26,NJN,29,7,535,61,134,.455,5,13,.385,56,121,.463,.474,38,43,.884,20,29,49,58,30,7,32,63,165
1985,Tom McMillen,C,32,WSB,69,21,1547,252,534,.472,0,5,.000,252,529,.476,.472,112,135,.830,64,146,210,52,8,17,44,163,616
1985,Mark McNamara,C,25,TOT,45,0,273,40,76,.526,0,0,,40,76,.526,.526,32,62,.516,31,43,74,6,7,8,19,27,112
1985,Mark McNamara,C,25,SAS,12,0,63,12,18,.667,0,0,,12,18,.667,.667,9,18,.500,7,10,17,0,2,1,6,5,33
1985,Mark McNamara,C,25,KCK,33,0,210,28,58,.483,0,0,,28,58,.483,.483,23,44,.523,24,33,57,6,5,7,13,22,79
1985,Joe Meriweather,C,31,KCK,76,4,1061,121,243,.498,1,2,.500,120,241,.498,.500,96,124,.774,94,169,263,27,17,28,50,181,339
1985,Larry Micheaux,PF,24,TOT,57,0,565,91,157,.580,0,3,.000,91,154,.591,.580,29,43,.674,62,81,143,30,20,21,36,75,211
1985,Larry Micheaux,PF,24,MIL,18,0,171,17,35,.486,0,0,,17,35,.486,.486,12,17,.706,18,26,44,13,8,7,8,26,46
1985,Larry Micheaux,PF,24,HOU,39,0,394,74,122,.607,0,3,.000,74,119,.622,.607,17,26,.654,44,55,99,17,12,14,28,49,165
1985,Mike Mitchell,SF,29,SAS,82,82,2853,775,1558,.497,5,23,.217,770,1535,.502,.499,269,346,.777,145,272,417,151,61,27,144,219,1824
1985,Paul Mokeski,C,28,MIL,79,6,1586,205,429,.478,0,2,.000,205,427,.480,.478,81,116,.698,107,303,410,99,28,35,85,266,491
1985,Sidney Moncrief*,PG,27,MIL,73,72,2734,561,1162,.483,9,33,.273,552,1129,.489,.487,454,548,.828,149,242,391,382,117,39,184,197,1585
1985,Johnny Moore,PG,26,SAS,82,82,2689,416,910,.457,25,89,.281,391,821,.476,.471,189,248,.762,94,284,378,816,229,18,236,247,1046
1985,Jay Murphy,PF,22,LAC,23,0,149,8,50,.160,0,1,.000,8,49,.163,.160,12,21,.571,6,35,41,4,1,2,8,21,28
1985,Larry Nance,PF,25,PHO,61,55,2202,515,877,.587,1,2,.500,514,875,.587,.588,180,254,.709,195,341,536,159,88,104,136,185,1211
1985,Calvin Natt,PF,28,DEN,78,76,2657,685,1255,.546,0,3,.000,685,1252,.547,.546,447,564,.793,209,401,610,238,75,33,190,182,1817
1985,Kenny Natt,SG,26,TOT,8,0,29,2,6,.333,0,0,,2,6,.333,.333,2,4,.500,2,1,3,3,2,0,3,3,6
1985,Kenny Natt,SG,26,UTA,4,0,13,2,5,.400,0,0,,2,5,.400,.400,2,4,.500,1,1,2,0,1,0,3,2,6
1985,Kenny Natt,SG,26,KCK,4,0,16,0,1,.000,0,0,,0,1,.000,.000,0,0,,1,0,1,3,1,0,0,1,0
1985,Ed Nealy,PF,24,KCK,22,0,225,26,44,.591,0,0,,26,44,.591,.591,10,19,.526,15,29,44,18,3,1,12,26,62
1985,Chuck Nevitt,C,25,LAL,11,0,59,5,17,.294,0,0,,5,17,.294,.294,2,8,.250,5,15,20,3,0,15,10,20,12
1985,Kurt Nimphius,C,26,DAL,82,40,2010,196,434,.452,0,6,.000,196,428,.458,.452,108,140,.771,136,272,408,183,30,126,95,262,500
1985,Norm Nixon,PG,29,LAC,81,81,2894,596,1281,.465,33,99,.333,563,1182,.476,.478,170,218,.780,55,163,218,711,95,4,273,175,1395
1985,Audie Norris,C,24,POR,78,13,1117,133,245,.543,0,3,.000,133,242,.550,.543,135,203,.665,90,160,250,47,42,33,100,221,401
1985,Mike O'Koren,SF,26,NJN,43,29,1119,194,393,.494,8,21,.381,186,372,.500,.504,42,67,.627,46,120,166,102,32,16,51,115,438
1985,Hakeem Olajuwon*,C,22,HOU,82,82,2914,677,1258,.538,0,0,,677,1258,.538,.538,338,551,.613,440,534,974,111,99,220,234,344,1692
1985,Mark Olberding,PF,28,KCK,81,62,2277,265,528,.502,0,3,.000,265,525,.505,.502,293,352,.832,139,374,513,243,56,11,185,298,823
1985,Jawann Oldham,C,27,CHI,63,0,993,89,192,.464,0,1,.000,89,191,.466,.464,34,50,.680,79,157,236,31,11,127,58,166,212
1985,Louis Orr,PF,26,NYK,79,31,2452,372,766,.486,1,10,.100,371,756,.491,.486,262,334,.784,171,220,391,134,100,27,138,195,1007
1985,Robert Parish*,C,31,BOS,79,78,2850,551,1016,.542,0,0,,551,1016,.542,.542,292,393,.743,263,577,840,125,56,101,186,223,1394
1985,Billy Paultz,C,36,UTA,62,0,370,32,87,.368,0,0,,32,87,.368,.368,18,28,.643,24,72,96,16,6,11,30,51,82
1985,Jim Paxson,SG,27,POR,68,57,2253,508,988,.514,6,39,.154,502,949,.529,.517,196,248,.790,69,153,222,264,101,5,108,115,1218
1985,John Paxson,PG,24,SAS,78,1,1259,196,385,.509,10,34,.294,186,351,.530,.522,84,100,.840,19,49,68,215,45,3,81,117,486
1985,Sam Perkins,PF,23,DAL,82,42,2317,347,736,.471,9,36,.250,338,700,.483,.478,200,244,.820,189,416,605,135,63,63,102,236,903
1985,Jim Petersen,PF,22,HOU,60,0,714,70,144,.486,0,0,,70,144,.486,.486,50,66,.758,44,103,147,29,14,32,71,125,190
1985,Ricky Pierce,SG,25,MIL,44,3,882,165,307,.537,1,4,.250,164,303,.541,.539,102,124,.823,49,68,117,94,34,5,63,117,433
1985,Charles Pittman,SF,26,PHO,68,3,1001,107,227,.471,0,2,.000,107,225,.476,.471,109,146,.747,90,137,227,69,20,21,100,144,323
1985,Gary Plummer,PF,22,GSW,66,0,702,92,232,.397,1,4,.250,91,228,.399,.399,65,92,.707,54,80,134,26,15,14,50,127,250
1985,David Pope,SF,22,KCK,22,0,129,17,53,.321,0,1,.000,17,52,.327,.321,7,13,.538,9,9,18,5,3,3,7,30,41
1985,Ben Poquette,PF,29,CLE,79,6,1656,210,457,.460,3,17,.176,207,440,.470,.463,109,137,.796,148,325,473,79,47,58,70,220,532
1985,Paul Pressey,SF,26,MIL,80,80,2876,480,928,.517,7,20,.350,473,908,.521,.521,317,418,.758,149,280,429,543,129,56,247,258,1284
1985,Kurt Rambis,PF,26,LAL,82,46,1617,181,327,.554,0,0,,181,327,.554,.554,68,103,.660,164,364,528,69,82,47,97,211,430
1985,Kelvin Ransey,PG,26,NJN,81,29,1689,300,654,.459,2,11,.182,298,643,.463,.460,122,142,.859,40,90,130,355,87,7,113,134,724
1985,Leo Rautins,SF,24,ATL,4,0,12,0,2,.000,0,0,,0,2,.000,.000,0,0,,1,1,2,3,0,0,1,3,0
1985,Robert Reid,SF,29,HOU,82,0,1763,312,648,.481,1,16,.063,311,632,.492,.482,88,126,.698,81,192,273,171,48,22,101,196,713
1985,Clint Richardson,SG,28,PHI,74,20,1531,183,404,.453,1,3,.333,182,401,.454,.454,76,89,.854,60,95,155,157,37,15,78,143,443
1985,Micheal Ray Richardson,PG,29,NJN,82,82,3127,690,1470,.469,29,115,.252,661,1355,.488,.479,240,313,.767,156,301,457,669,243,22,249,277,1649
1985,Doc Rivers,PG,23,ATL,69,58,2126,334,701,.476,15,36,.417,319,665,.480,.487,291,378,.770,66,148,214,410,163,53,176,250,974
1985,Fred Roberts,PF,24,TOT,74,0,1178,208,418,.498,1,1,1.000,207,417,.496,.499,150,182,.824,78,108,186,87,28,22,89,141,567
1985,Fred Roberts,PF,24,SAS,22,0,305,44,98,.449,0,0,,44,98,.449,.449,29,38,.763,10,25,35,22,10,12,21,45,117
1985,Fred Roberts,PF,24,UTA,52,0,873,164,320,.513,1,1,1.000,163,319,.511,.514,121,144,.840,68,83,151,65,18,10,68,96,450
1985,Alvin Robertson,SG,22,SAS,79,9,1685,299,600,.498,4,11,.364,295,589,.501,.502,124,169,.734,116,149,265,275,127,24,167,217,726
1985,Rick Robey,C,29,PHO,4,0,48,2,9,.222,0,0,,2,9,.222,.222,1,2,.500,3,5,8,5,2,0,8,7,5
1985,Cliff Robinson,PF,24,WSB,60,37,1870,422,896,.471,1,3,.333,421,893,.471,.472,158,213,.742,141,405,546,149,51,47,161,187,1003
1985,Truck Robinson,PF,33,NYK,2,1,35,2,5,.400,0,0,,2,5,.400,.400,0,2,.000,6,3,9,3,2,3,5,3,4
1985,Tree Rollins,C,29,ATL,70,60,1750,186,339,.549,0,0,,186,339,.549,.549,67,93,.720,113,329,442,52,35,167,80,213,439
1985,Lorenzo Romar,PG,26,TOT,9,0,51,3,16,.188,0,3,.000,3,13,.231,.188,5,5,1.000,0,0,0,12,4,0,5,7,11
1985,Lorenzo Romar,PG,26,MIL,4,0,16,1,8,.125,0,1,.000,1,7,.143,.125,0,0,,0,0,0,2,0,0,0,2,2
1985,Lorenzo Romar,PG,26,DET,5,0,35,2,8,.250,0,2,.000,2,6,.333,.250,5,5,1.000,0,0,0,10,4,0,5,5,9
1985,Dan Roundfield,PF,31,DET,56,43,1492,236,505,.467,0,2,.000,236,503,.469,.467,139,178,.781,175,278,453,102,26,54,123,147,611
1985,Jeff Ruland,C,26,WSB,37,36,1436,250,439,.569,0,2,.000,250,437,.572,.569,200,292,.685,127,283,410,162,31,27,179,128,700
1985,Campy Russell,SF,33,CLE,3,0,24,2,7,.286,0,1,.000,2,6,.333,.286,2,3,.667,0,5,5,3,0,0,5,3,6
1985,Walker Russell,PG,24,ATL,21,2,377,34,63,.540,1,1,1.000,33,62,.532,.548,14,17,.824,8,32,40,66,17,4,40,37,83
1985,Ralph Sampson*,PF,24,HOU,82,82,3086,753,1499,.502,0,6,.000,753,1493,.504,.502,303,448,.676,227,626,853,224,81,168,326,306,1809
1985,Mike Sanders,SF,24,PHO,21,11,418,85,175,.486,0,0,,85,175,.486,.486,45,59,.763,38,51,89,29,23,4,34,59,215
1985,Wayne Sappleton,PF,24,NJN,33,0,298,41,87,.471,0,0,,41,87,.471,.471,14,34,.412,28,47,75,7,7,4,21,50,96
1985,Danny Schayes,C,25,DEN,56,0,542,60,129,.465,0,0,,60,129,.465,.465,79,97,.814,48,96,144,38,20,25,44,98,199
1985,Tom Scheffler,C,30,POR,39,0,268,21,51,.412,0,0,,21,51,.412,.412,10,20,.500,18,58,76,11,8,11,15,48,52
1985,John Schweitz,SG,24,SEA,19,0,110,25,74,.338,0,4,.000,25,70,.357,.338,7,10,.700,6,15,21,18,0,1,14,12,57
1985,Alvin Scott,SF,29,PHO,77,18,1238,111,259,.429,1,5,.200,110,254,.433,.431,53,74,.716,46,115,161,127,39,25,60,125,276
1985,Byron Scott,SG,23,LAL,81,65,2305,541,1003,.539,26,60,.433,515,943,.546,.552,187,228,.820,57,153,210,244,100,17,138,197,1295
1985,Tom Sewell,SG,22,WSB,21,0,87,9,36,.250,0,2,.000,9,34,.265,.250,2,4,.500,2,2,4,6,3,1,7,13,20
1985,Lonnie Shelton,PF,29,CLE,57,14,1244,158,363,.435,0,5,.000,158,358,.441,.435,51,77,.662,82,185,267,96,44,18,74,187,367
1985,Purvis Short,SF,27,GSW,78,77,3081,819,1780,.460,47,150,.313,772,1630,.474,.473,501,613,.817,157,241,398,234,116,27,241,255,2186
1985,Jerry Sichting,PG,28,IND,70,25,1808,325,624,.521,9,37,.243,316,587,.538,.528,112,128,.875,24,90,114,264,47,4,102,116,771
1985,Jack Sikma*,C,29,SEA,68,68,2402,461,943,.489,2,10,.200,459,933,.492,.490,335,393,.852,164,559,723,285,83,91,160,239,1259
1985,Charlie Sitton,SF,22,DAL,43,0,304,39,94,.415,0,2,.000,39,92,.424,.415,13,25,.520,24,36,60,26,7,6,19,50,91
1985,Tom Sluby,SG,22,DAL,31,0,151,30,58,.517,0,2,.000,30,56,.536,.517,13,21,.619,5,7,12,16,3,0,11,18,73
1985,Derek Smith,SG,23,LAC,80,80,2762,682,1271,.537,3,19,.158,679,1252,.542,.538,400,504,.794,174,253,427,216,77,52,230,317,1767
1985,Larry Smith,PF,27,GSW,80,78,2497,366,690,.530,0,0,,366,690,.530,.530,155,256,.605,405,464,869,96,78,54,160,285,887
1985,Robert Smith,PG,29,CLE,7,0,48,4,17,.235,0,4,.000,4,13,.308,.235,8,10,.800,0,4,4,7,2,0,3,6,16
1985,Ricky Sobers,SG,32,SEA,71,12,1490,280,628,.446,8,28,.286,272,600,.453,.452,132,162,.815,27,76,103,252,49,9,158,156,700
1985,Rory Sparrow,PG,26,NYK,79,41,2292,326,662,.492,7,31,.226,319,631,.506,.498,122,141,.865,38,131,169,557,81,9,150,200,781
1985,Larry Spriggs,PF,25,LAL,75,32,1292,194,354,.548,0,3,.000,194,351,.553,.548,112,146,.767,77,150,227,132,47,13,115,195,500
1985,Terence Stansbury,SG,23,IND,74,14,1278,210,458,.459,4,25,.160,206,433,.476,.463,102,126,.810,39,75,114,127,47,12,80,205,526
1985,Brook Steppe,SG,25,DET,54,0,486,83,178,.466,0,1,.000,83,177,.469,.466,87,104,.837,25,32,57,36,16,4,43,61,253
1985,Steve Stipanovich,C,24,IND,82,66,2315,414,871,.475,1,11,.091,413,860,.480,.476,297,372,.798,141,473,614,199,71,78,184,265,1126
1985,John Stockton*,PG,22,UTA,82,5,1490,157,333,.471,2,11,.182,155,322,.481,.474,142,193,.736,26,79,105,415,109,11,150,203,458
1985,Jon Sundvold,PG,23,SEA,73,1,1150,170,400,.425,12,38,.316,158,362,.436,.440,48,59,.814,17,53,70,206,36,1,85,87,400
1985,Dane Suttle,SG,23,KCK,6,0,24,6,13,.462,0,1,.000,6,12,.500,.462,2,2,1.000,0,3,3,2,1,0,1,3,14
1985,Terry Teagle,SG,24,TOT,21,3,349,74,137,.540,2,4,.500,72,133,.541,.547,25,35,.714,22,21,43,14,13,5,15,36,175
1985,Terry Teagle,SG,24,DET,2,0,5,1,2,.500,0,0,,1,2,.500,.500,0,0,,0,0,0,0,0,0,1,2,2
1985,Terry Teagle,SG,24,GSW,19,3,344,73,135,.541,2,4,.500,71,131,.542,.548,25,35,.714,22,21,43,14,13,5,14,34,173
1985,Reggie Theus,SG,27,KCK,82,80,2543,501,1029,.487,5,38,.132,496,991,.501,.489,334,387,.863,106,164,270,656,95,18,307,250,1341
1985,Peter Thibeaux,SF,23,GSW,51,1,461,94,195,.482,0,2,.000,94,193,.487,.482,43,67,.642,29,40,69,17,11,17,34,85,231
1985,David Thirdkill,SF,24,TOT,18,3,183,20,38,.526,0,1,.000,20,37,.541,.526,11,19,.579,10,7,17,4,5,3,14,22,51
1985,David Thirdkill,SF,24,DET,10,1,115,12,23,.522,0,1,.000,12,22,.545,.522,5,11,.455,4,4,8,1,3,2,12,16,29
1985,David Thirdkill,SF,24,MIL,6,0,16,3,4,.750,0,0,,3,4,.750,.750,1,2,.500,1,1,2,0,0,0,0,1,7
1985,David Thirdkill,SF,24,SAS,2,2,52,5,11,.455,0,0,,5,11,.455,.455,5,6,.833,5,2,7,3,2,1,2,5,15
1985,Isiah Thomas*,PG,23,DET,81,81,3089,646,1410,.458,29,113,.257,617,1297,.476,.468,399,493,.809,114,247,361,1123,187,25,302,288,1720
1985,Jim Thomas,SG,24,IND,80,52,2059,347,726,.478,8,42,.190,339,684,.496,.483,183,234,.782,74,187,261,234,76,5,131,195,885
1985,Bernard Thompson,SF,22,POR,59,0,535,79,212,.373,0,8,.000,79,204,.387,.373,39,51,.765,37,39,76,52,31,10,35,79,197
1985,LaSalle Thompson,C,23,KCK,82,77,2458,369,695,.531,0,0,,369,695,.531,.531,227,315,.721,274,580,854,130,98,128,202,328,965
1985,Mychal Thompson,PF,30,POR,79,55,2616,572,1111,.515,0,0,,572,1111,.515,.515,307,449,.684,211,407,618,205,78,104,231,216,1451
1985,Paul Thompson,SF,23,TOT,49,27,942,189,459,.412,6,30,.200,183,429,.427,.418,69,87,.793,57,101,158,78,56,25,57,119,453
1985,Paul Thompson,SF,23,CLE,33,27,715,148,354,.418,6,23,.261,142,331,.429,.427,45,53,.849,36,80,116,58,41,20,42,77,347
1985,Paul Thompson,SF,23,MIL,16,0,227,41,105,.390,0,7,.000,41,98,.418,.390,24,34,.706,21,21,42,20,15,5,15,42,106
1985,Otis Thorpe,PF,22,KCK,82,23,1918,411,685,.600,0,2,.000,411,683,.602,.600,230,371,.620,187,369,556,111,34,37,187,256,1052
1985,Sedale Threatt,PG,23,PHI,82,0,1304,188,416,.452,4,22,.182,184,394,.467,.457,66,90,.733,21,78,99,175,80,16,99,171,446
1985,Andrew Toney,SG,27,PHI,70,65,2237,450,914,.492,39,105,.371,411,809,.508,.514,306,355,.862,35,142,177,363,65,24,224,211,1245
1985,Linton Townes,SF,25,SAS,1,0,8,0,6,.000,0,0,,0,6,.000,.000,2,2,1.000,1,0,1,0,0,0,0,1,2
1985,Kelly Tripucka,SF,25,DET,55,43,1675,396,831,.477,2,5,.400,394,826,.477,.478,255,288,.885,66,152,218,135,49,14,118,118,1049
1985,Trent Tucker,SG,25,NYK,77,46,1819,293,606,.483,29,72,.403,264,534,.494,.507,38,48,.792,74,114,188,199,75,15,64,195,653
1985,Elston Turner,SF,25,DEN,81,2,1491,181,388,.466,1,6,.167,180,382,.471,.468,51,65,.785,88,128,216,158,96,7,70,152,414
1985,Jeff Turner,PF,22,NJN,72,36,1429,171,377,.454,0,3,.000,171,374,.457,.454,79,92,.859,88,130,218,108,29,7,90,243,421
1985,Melvin Turpin,C,24,CLE,79,45,1949,363,711,.511,0,0,,363,711,.511,.511,109,139,.784,155,297,452,36,38,87,118,211,835
1985,Terry Tyler,SF,28,DET,82,53,2004,422,855,.494,0,8,.000,422,847,.498,.494,106,148,.716,148,275,423,63,49,90,76,192,950
1985,Darnell Valentine,PG,25,POR,75,59,2278,321,679,.473,0,2,.000,321,677,.474,.473,230,290,.793,54,165,219,522,143,5,194,189,872
1985,Kiki Vandeweghe,SF,26,POR,72,69,2502,618,1158,.534,11,33,.333,607,1125,.540,.538,369,412,.896,74,154,228,106,37,22,116,116,1616
1985,Pete Verhoeven,PF,25,KCK,54,0,366,51,108,.472,0,0,,51,108,.472,.472,21,25,.840,28,35,63,17,15,7,20,85,123
1985,Jay Vincent,PF,25,DAL,79,47,2543,545,1138,.479,0,4,.000,545,1134,.481,.479,351,420,.836,185,519,704,169,48,22,170,226,1441
1985,Danny Vranes,SF,26,SEA,76,70,2163,186,402,.463,1,4,.250,185,398,.465,.464,67,127,.528,154,282,436,152,76,57,119,256,440
1985,Granville Waiters,C,24,IND,62,5,703,85,190,.447,0,1,.000,85,189,.450,.447,29,50,.580,57,113,170,30,16,44,55,107,199
1985,Darrell Walker,PG,23,NYK,82,66,2489,430,989,.435,0,17,.000,430,972,.442,.435,243,347,.700,128,150,278,408,167,21,204,244,1103
1985,Bill Walton*,C,32,LAC,67,37,1647,269,516,.521,0,2,.000,269,514,.523,.521,138,203,.680,168,432,600,156,50,140,174,184,676
1985,Bryan Warrick,PG,25,LAC,58,1,713,85,173,.491,1,4,.250,84,169,.497,.494,44,57,.772,10,48,58,153,23,6,70,85,215
1985,Scott Wedman,SF,32,BOS,78,5,1127,220,460,.478,17,34,.500,203,426,.477,.497,42,55,.764,57,102,159,94,23,10,47,111,499
1985,Mark West,C,24,TOT,66,25,888,106,194,.546,0,1,.000,106,193,.549,.546,43,87,.494,90,161,251,15,13,49,59,197,255
1985,Mark West,C,24,MIL,1,0,6,0,1,.000,0,0,,0,1,.000,.000,2,2,1.000,1,0,1,0,0,1,2,4,2
1985,Mark West,C,24,CLE,65,25,882,106,193,.549,0,1,.000,106,192,.552,.549,41,85,.482,89,161,250,15,13,48,57,193,253
1985,Ennis Whatley,PG,22,CHI,70,44,1385,140,313,.447,1,9,.111,139,304,.457,.449,68,86,.791,34,67,101,381,66,10,144,141,349
1985,Rory White,PF,25,LAC,80,14,1106,144,279,.516,0,0,,144,279,.516,.516,90,130,.692,94,101,195,34,35,20,87,115,378
1985,Willie White,SG,22,DEN,39,0,234,52,124,.419,4,11,.364,48,113,.425,.435,21,31,.677,15,21,36,29,5,2,30,24,129
1985,Jerome Whitehead,C,28,GSW,79,78,2536,421,825,.510,0,0,,421,825,.510,.510,184,235,.783,219,403,622,53,45,43,141,322,1026
1985,Mitchell Wiggins,SG,25,HOU,82,24,1575,318,657,.484,6,23,.261,312,634,.492,.489,96,131,.733,110,125,235,119,83,13,90,195,738
1985,Jamaal Wilkes*,SF,31,LAL,42,8,761,148,303,.488,0,1,.000,148,302,.490,.488,51,66,.773,35,59,94,41,19,3,49,65,347
1985,Dominique Wilkins*,SF,25,ATL,81,81,3023,853,1891,.451,25,81,.309,828,1810,.457,.458,486,603,.806,226,331,557,200,135,54,225,170,2217
1985,Eddie Lee Wilkins,C,22,NYK,54,16,917,116,233,.498,0,2,.000,116,231,.502,.498,66,122,.541,86,176,262,16,21,16,64,155,298
1985,Jeff Wilkins,C,29,UTA,79,0,1505,285,582,.490,0,1,.000,285,581,.491,.490,61,80,.763,78,288,366,81,35,18,91,173,631
1985,Dale Wilkinson,SF-PF,24,TOT,12,0,45,4,16,.250,0,1,.000,4,15,.267,.250,6,7,.857,1,3,4,2,0,0,4,10,14
1985,Dale Wilkinson,PF,24,DET,2,0,7,0,2,.000,0,0,,0,2,.000,.000,0,0,,0,1,1,0,0,0,0,2,0
1985,Dale Wilkinson,SF,24,LAC,10,0,38,4,14,.286,0,1,.000,4,13,.308,.286,6,7,.857,1,2,3,2,0,0,4,8,14
1985,Buck Williams,PF,24,NJN,82,82,3182,577,1089,.530,1,4,.250,576,1085,.531,.530,336,538,.625,323,682,1005,167,63,110,238,293,1491
1985,Gus Williams,PG,31,WSB,79,78,2960,638,1483,.430,51,176,.290,587,1307,.449,.447,251,346,.725,72,123,195,608,178,32,213,159,1578
1985,Guy Williams,SF,24,WSB,21,0,119,29,63,.460,1,4,.250,28,59,.475,.468,2,5,.400,15,12,27,9,5,2,8,17,61
1985,Herb Williams,C,26,IND,75,70,2557,575,1211,.475,1,9,.111,574,1202,.478,.475,224,341,.657,154,480,634,252,54,134,265,218,1375
1985,Kevin Williams,SG,23,CLE,46,4,413,58,134,.433,0,5,.000,58,129,.450,.433,47,64,.734,19,44,63,61,22,4,49,86,163
1985,Ray Williams,PG,30,BOS,23,5,459,55,143,.385,6,23,.261,49,120,.408,.406,31,46,.674,16,41,57,90,30,5,42,56,147
1985,Sam Williams,PF,25,PHI,46,8,488,58,148,.392,0,1,.000,58,147,.395,.392,28,47,.596,38,68,106,11,26,26,44,92,144
1985,Sly Williams,SF,27,ATL,34,20,867,167,380,.439,4,15,.267,163,365,.447,.445,79,123,.642,45,123,168,94,28,8,78,83,417
1985,Kevin Willis,PF,22,ATL,82,19,1785,322,690,.467,2,9,.222,320,681,.470,.468,119,181,.657,177,345,522,36,31,49,104,226,765
1985,Michael Wilson,SG,25,TOT,19,0,267,36,77,.468,0,0,,36,77,.468,.468,27,36,.750,14,17,31,35,14,5,20,21,99
1985,Michael Wilson,SG,25,CLE,11,0,175,27,54,.500,0,0,,27,54,.500,.500,23,30,.767,10,8,18,24,10,3,15,14,77
1985,Michael Wilson,SG,25,NJN,8,0,92,9,23,.391,0,0,,9,23,.391,.391,4,6,.667,4,9,13,11,4,2,5,7,22
1985,Othell Wilson,PG,23,GSW,74,23,1260,134,291,.460,3,16,.188,131,275,.476,.466,54,76,.711,35,96,131,217,77,12,95,122,325
1985,Randy Wittman,SG,25,ATL,41,22,1168,187,352,.531,2,7,.286,185,345,.536,.534,30,41,.732,16,57,73,125,28,7,57,58,406
1985,Al Wood,SG,26,SEA,80,79,2545,515,1061,.485,7,33,.212,508,1028,.494,.489,166,214,.776,99,180,279,236,84,52,120,187,1203
1985,Leon Wood,PG,22,PHI,38,1,269,50,134,.373,4,30,.133,46,104,.442,.388,18,26,.692,3,15,18,45,8,0,25,17,122
1985,Mike Woodson,SG,26,KCK,78,3,1998,530,1068,.496,5,21,.238,525,1047,.501,.499,264,330,.800,69,129,198,143,117,28,139,216,1329
1985,Orlando Woolridge,SF,25,CHI,77,76,2816,679,1225,.554,0,5,.000,679,1220,.557,.554,409,521,.785,158,277,435,135,58,38,178,185,1767
1985,James Worthy*,SF,23,LAL,80,76,2696,610,1066,.572,0,7,.000,610,1059,.576,.572,190,245,.776,169,342,511,201,87,67,198,196,1410
1985,Danny Young,PG,22,SEA,3,0,26,2,10,.200,0,1,.000,2,9,.222,.200,0,0,,0,3,3,2,3,0,2,2,4
1985,Michael Young,SF,24,PHO,2,0,11,2,6,.333,0,1,.000,2,5,.400,.333,0,0,,1,1,2,0,0,0,0,0,4
1986,Kareem Abdul-Jabbar*,C,38,LAL,79,79,2629,755,1338,.564,0,2,.000,755,1336,.565,.564,336,439,.765,133,345,478,280,67,130,203,248,1846
1986,Alvan Adams,C,31,PHO,78,45,2005,341,679,.502,0,2,.000,341,677,.504,.502,159,203,.783,148,329,477,324,103,46,206,272,841
1986,Michael Adams,PG,23,SAC,18,0,139,16,44,.364,0,3,.000,16,41,.390,.364,8,12,.667,2,4,6,22,9,1,11,9,40
1986,Mark Aguirre,SF,26,DAL,74,73,2501,668,1327,.503,16,56,.286,652,1271,.513,.509,318,451,.705,177,268,445,339,62,14,252,229,1670
1986,Danny Ainge,SG,26,BOS,80,78,2407,353,701,.504,26,73,.356,327,628,.521,.522,123,136,.904,47,188,235,405,94,7,129,204,855
1986,Ron Anderson,SF,27,TOT,77,30,1676,310,628,.494,2,9,.222,308,619,.498,.495,85,127,.669,130,144,274,144,56,6,82,125,707
1986,Ron Anderson,SF,27,CLE,17,3,207,37,74,.500,0,1,.000,37,73,.507,.500,12,16,.750,5,21,26,8,1,0,6,20,86
1986,Ron Anderson,SF,27,IND,60,27,1469,273,554,.493,2,8,.250,271,546,.496,.495,73,111,.658,125,123,248,136,55,6,76,105,621
1986,John Bagley,PG,25,CLE,78,77,2472,366,865,.423,9,37,.243,357,828,.431,.428,170,215,.791,76,199,275,735,122,10,239,165,911
1986,James Bailey,PF,28,NYK,48,36,1245,202,443,.456,0,4,.000,202,439,.460,.456,129,167,.772,102,232,334,50,33,40,99,207,533
1986,Thurl Bailey,PF,24,UTA,82,13,2358,483,1077,.448,0,7,.000,483,1070,.451,.448,230,277,.830,148,345,493,153,42,114,144,160,1196
1986,Greg Ballard,SF,31,GSW,75,14,1792,272,570,.477,17,35,.486,255,535,.477,.492,101,126,.802,132,285,417,83,65,8,54,174,662
1986,Gene Banks,SF,26,CHI,82,33,2139,356,688,.517,0,19,.000,356,669,.532,.517,183,255,.718,178,182,360,251,81,10,139,212,895
1986,Ken Bannister,PF,25,NYK,70,15,1405,235,479,.491,0,1,.000,235,478,.492,.491,131,249,.526,89,233,322,42,42,24,129,208,601
1986,Charles Barkley*,PF,22,PHI,80,80,2952,595,1041,.572,17,75,.227,578,966,.598,.580,396,578,.685,354,672,1026,312,173,125,350,333,1603
1986,John Battle,SG,23,ATL,64,0,639,101,222,.455,0,7,.000,101,215,.470,.455,75,103,.728,12,50,62,74,23,3,47,80,277
1986,Benoit Benjamin,C,21,LAC,79,37,2088,324,661,.490,1,3,.333,323,658,.491,.491,229,307,.746,161,439,600,79,64,206,145,286,878
1986,Kent Benson,C,31,DET,72,51,1344,201,415,.484,1,2,.500,200,413,.484,.486,66,83,.795,118,258,376,80,58,51,58,196,469
1986,Larry Bird*,SF,29,BOS,82,81,3113,796,1606,.496,82,194,.423,714,1412,.506,.521,441,492,.896,190,615,805,557,166,51,266,182,2115
1986,Otis Birdsong,SG,30,NJN,77,74,2395,542,1056,.513,8,22,.364,534,1034,.516,.517,122,210,.581,88,114,202,261,85,17,179,228,1214
1986,Uwe Blab,C,23,DAL,48,0,409,44,94,.468,0,0,,44,94,.468,.468,36,67,.537,25,66,91,17,3,12,28,65,124
1986,Rolando Blackman,SG,26,DAL,82,81,2787,677,1318,.514,4,29,.138,673,1289,.522,.515,404,483,.836,88,203,291,271,79,25,189,138,1762
1986,Manute Bol,C,23,WSB,80,60,2090,128,278,.460,0,1,.000,128,277,.462,.460,42,86,.488,123,354,477,23,28,397,65,255,298
1986,Sam Bowie,C,24,POR,38,34,1132,167,345,.484,0,0,,167,345,.484,.484,114,161,.708,93,234,327,99,21,96,88,142,448
1986,Dudley Bradley,SG,28,WSB,70,7,842,73,209,.349,17,68,.250,56,141,.397,.390,32,56,.571,24,71,95,107,85,3,44,101,195
1986,Mike Bratz,PG,30,SAC,33,0,269,26,70,.371,4,14,.286,22,56,.393,.400,14,18,.778,2,21,23,39,13,0,17,43,70
1986,Randy Breuer,C,25,MIL,82,63,1792,272,570,.477,0,1,.000,272,569,.478,.477,141,198,.712,159,299,458,114,50,116,122,214,685
1986,Ron Brewer,SG,30,TOT,44,3,570,86,224,.384,5,17,.294,81,207,.391,.395,34,38,.895,14,39,53,40,17,6,23,44,211
1986,Ron Brewer,SG,30,CHI,4,0,18,3,9,.333,0,0,,3,9,.333,.333,1,1,1.000,0,0,0,0,0,0,2,1,7
1986,Ron Brewer,SG,30,CLE,40,3,552,83,215,.386,5,17,.294,78,198,.394,.398,33,37,.892,14,39,53,40,17,6,21,43,204
1986,Frank Brickowski,C,26,SEA,40,2,311,30,58,.517,0,0,,30,58,.517,.517,18,27,.667,16,38,54,21,11,7,23,74,78
1986,Junior Bridgeman,SF,32,LAC,58,14,1161,199,451,.441,6,18,.333,193,433,.446,.448,106,119,.891,29,94,123,108,31,8,68,81,510
1986,Mike Brittain,C,22,SAS,32,2,219,22,43,.512,0,0,,22,43,.512,.512,10,19,.526,10,39,49,5,3,12,20,54,54
1986,Tony Brown,SG,25,CHI,10,0,132,18,41,.439,0,2,.000,18,39,.462,.439,9,13,.692,5,11,16,14,5,1,4,16,45
1986,Wallace Bryant,C,26,TOT,17,8,218,15,48,.313,0,0,,15,48,.313,.313,11,19,.579,17,36,53,15,5,5,9,38,41
1986,Wallace Bryant,C,26,DAL,9,8,154,11,30,.367,0,0,,11,30,.367,.367,6,11,.545,9,24,33,11,3,2,7,26,28
1986,Wallace Bryant,C,26,LAC,8,0,64,4,18,.222,0,0,,4,18,.222,.222,5,8,.625,8,12,20,4,2,3,2,12,13
1986,Quinn Buckner,PG,31,IND,32,3,419,49,104,.471,0,1,.000,49,103,.476,.471,19,27,.704,9,42,51,86,40,3,55,80,117
1986,Michael Cage,PF,24,LAC,78,12,1566,204,426,.479,0,3,.000,204,423,.482,.479,113,174,.649,168,249,417,81,62,34,106,176,521
1986,Tony Campbell,SF,23,DET,82,1,1292,294,608,.484,2,9,.222,292,599,.487,.485,58,73,.795,83,153,236,45,62,7,86,164,648
1986,Rick Carlisle,SG,26,BOS,77,1,760,92,189,.487,0,10,.000,92,179,.514,.487,15,23,.652,22,55,77,104,19,4,50,92,199
1986,Antoine Carr,PF,24,ATL,17,0,258,49,93,.527,0,0,,49,93,.527,.527,18,27,.667,16,36,52,14,7,15,14,51,116
1986,Kenny Carr,PF,30,POR,55,31,1557,232,466,.498,0,4,.000,232,462,.502,.498,149,217,.687,146,346,492,70,38,30,106,203,613
1986,Joe Barry Carroll,C,27,GSW,79,79,2801,650,1404,.463,0,2,.000,650,1402,.464,.463,377,501,.752,193,477,670,176,101,143,275,277,1677
1986,Butch Carter,SG,27,TOT,9,0,67,7,24,.292,0,1,.000,7,23,.304,.292,6,7,.857,2,2,4,4,1,0,7,14,20
1986,Butch Carter,SG,27,NYK,5,0,31,2,8,.250,0,1,.000,2,7,.286,.250,1,1,1.000,2,1,3,3,1,0,6,6,5
1986,Butch Carter,SG,27,PHI,4,0,36,5,16,.313,0,0,,5,16,.313,.313,5,6,.833,0,1,1,1,0,0,1,8,15
1986,Bill Cartwright,C,28,NYK,2,0,36,3,7,.429,0,0,,3,7,.429,.429,6,10,.600,2,8,10,5,1,1,6,6,12
1986,Terry Catledge,PF,22,PHI,64,7,1092,202,431,.469,0,4,.000,202,427,.473,.469,90,139,.647,107,165,272,21,31,8,69,127,494
1986,Bobby Cattage,PF,27,NJN,29,1,185,28,83,.337,1,5,.200,27,78,.346,.343,35,44,.795,15,19,34,4,6,0,13,23,92
1986,Tom Chambers,PF,26,SEA,66,26,2019,432,928,.466,13,48,.271,419,880,.476,.473,346,414,.836,126,305,431,132,55,37,194,248,1223
1986,Lorenzo Charles,SF,22,ATL,36,0,273,49,88,.557,0,0,,49,88,.557,.557,24,36,.667,13,26,39,8,2,6,18,37,122
1986,Maurice Cheeks*,PG,29,PHI,82,82,3270,490,913,.537,4,17,.235,486,896,.542,.539,282,335,.842,55,180,235,753,207,27,238,160,1266
1986,Fred Cofield,PG,24,NYK,45,1,469,75,184,.408,3,15,.200,72,169,.426,.416,12,20,.600,6,40,46,82,20,3,49,65,165
1986,Steve Colter,PG,23,POR,81,51,1868,272,597,.456,27,83,.325,245,514,.477,.478,135,164,.823,41,136,177,257,113,10,115,188,706
1986,Lester Conner,PG,26,GSW,36,0,413,51,136,.375,2,7,.286,49,129,.380,.382,40,54,.741,25,37,62,43,24,1,15,23,144
1986,Darwin Cook,PG,27,NJN,79,33,1965,267,627,.426,11,53,.208,256,574,.446,.435,84,111,.757,51,126,177,390,156,22,132,172,629
1986,Jeff Cook,PF,29,TOT,36,0,373,31,73,.425,0,1,.000,31,72,.431,.425,27,42,.643,33,53,86,21,13,11,14,65,89
1986,Jeff Cook,PF,29,SAS,34,0,356,28,67,.418,0,1,.000,28,66,.424,.418,26,41,.634,31,50,81,21,13,11,11,64,82
1986,Jeff Cook,PF,29,UTA,2,0,17,3,6,.500,0,0,,3,6,.500,.500,1,1,1.000,2,3,5,0,0,0,3,1,7
1986,David Cooke,PF,22,SAC,6,0,38,2,11,.182,0,0,,2,11,.182,.182,5,10,.500,5,5,10,1,4,0,2,5,9
1986,Michael Cooper,SG,29,LAL,82,15,2269,274,606,.452,63,163,.387,211,443,.476,.504,147,170,.865,44,200,244,466,89,43,151,238,758
1986,Wayne Cooper,C,29,DEN,78,78,2112,422,906,.466,3,7,.429,419,899,.466,.467,174,219,.795,190,420,610,81,42,227,117,315,1021
1986,Tyrone Corbin,SF,23,SAS,16,0,174,27,64,.422,0,1,.000,27,63,.429,.422,10,14,.714,11,14,25,11,11,2,12,21,64
1986,Dave Corzine,C,29,CHI,67,4,1709,255,519,.491,3,12,.250,252,507,.497,.494,127,171,.743,132,301,433,150,28,53,104,133,640
1986,Ron Crevier,C,27,TOT,3,0,4,0,3,.000,0,0,,0,3,.000,.000,0,2,.000,1,0,1,0,0,0,0,2,0
1986,Ron Crevier,C,27,GSW,1,0,1,0,1,.000,0,0,,0,1,.000,.000,0,0,,0,0,0,0,0,0,0,0,0
1986,Ron Crevier,C,27,DET,2,0,3,0,2,.000,0,0,,0,2,.000,.000,0,2,.000,1,0,1,0,0,0,0,2,0
1986,Jeff Cross,PF,24,LAC,21,0,128,6,24,.250,0,0,,6,24,.250,.250,14,25,.560,9,21,30,1,2,3,6,38,26
1986,Pat Cummings,C,29,NYK,31,30,1007,195,408,.478,0,2,.000,195,406,.480,.478,97,139,.698,92,188,280,47,27,12,87,136,487
1986,Terry Cummings,PF,24,MIL,82,82,2669,681,1438,.474,0,2,.000,681,1436,.474,.474,265,404,.656,222,472,694,193,121,51,191,283,1627
1986,Earl Cureton,PF,28,DET,80,19,2017,285,564,.505,0,2,.000,285,562,.507,.505,117,211,.555,198,306,504,137,58,58,150,239,687
1986,Quintin Dailey,SG,25,CHI,35,0,723,203,470,.432,0,8,.000,203,462,.439,.432,163,198,.823,20,48,68,67,22,5,67,86,569
1986,Adrian Dantley*,SF,30,UTA,76,75,2744,818,1453,.563,1,11,.091,817,1442,.567,.563,630,796,.791,178,217,395,264,64,4,231,206,2267
1986,Brad Davis,PG,30,DAL,82,43,1971,267,502,.532,32,89,.360,235,413,.569,.564,198,228,.868,26,120,146,467,57,15,110,174,764
1986,Charles Davis,SF,27,MIL,57,7,873,188,397,.474,3,24,.125,185,373,.496,.477,61,75,.813,60,110,170,55,26,7,50,113,440
1986,Johnny Davis,SG,30,TOT,66,7,1014,148,344,.430,3,13,.231,145,331,.438,.435,118,138,.855,8,47,55,217,37,4,78,76,417
1986,Johnny Davis,SG,30,CLE,39,0,612,102,237,.430,2,11,.182,100,226,.442,.435,67,79,.848,6,30,36,105,24,4,40,44,273
1986,Johnny Davis,SG,30,ATL,27,7,402,46,107,.430,1,2,.500,45,105,.429,.435,51,59,.864,2,17,19,112,13,0,38,32,144
1986,Walter Davis,SG,31,PHO,70,62,2239,624,1287,.485,18,76,.237,606,1211,.500,.492,257,305,.843,54,149,203,361,99,3,219,153,1523
1986,Darryl Dawkins,C,29,NJN,51,3,1207,284,441,.644,0,1,.000,284,440,.645,.644,210,297,.707,85,166,251,77,16,59,124,227,778
1986,Darren Daye,SF,25,WSB,64,4,1075,198,399,.496,1,3,.333,197,396,.497,.497,159,237,.671,71,112,183,109,46,11,98,121,556
1986,James Donaldson,C,28,TOT,83,78,2682,256,459,.558,0,0,,256,459,.558,.558,204,254,.803,171,624,795,96,28,139,123,189,716
1986,James Donaldson,C,28,LAC,14,14,441,43,84,.512,0,0,,43,84,.512,.512,57,70,.814,28,103,131,12,5,29,38,33,143
1986,James Donaldson,C,28,DAL,69,64,2241,213,375,.568,0,0,,213,375,.568,.568,147,184,.799,143,521,664,84,23,110,85,156,573
1986,Larry Drew,PG,27,SAC,75,31,1971,376,776,.485,10,31,.323,366,745,.491,.491,128,161,.795,25,100,125,338,66,2,133,134,890
1986,Clyde Drexler*,SG,23,POR,75,58,2576,542,1142,.475,12,60,.200,530,1082,.490,.480,293,381,.769,171,250,421,600,197,46,282,270,1389
1986,Joe Dumars*,SG,22,DET,82,45,1957,287,597,.481,5,16,.313,282,581,.485,.485,190,238,.798,60,59,119,390,66,11,158,200,769
1986,T.R. Dunn,SG,30,DEN,82,82,2401,172,379,.454,0,1,.000,172,378,.455,.454,68,88,.773,143,234,377,171,155,16,51,228,412
1986,Devin Durrant,SF,25,PHO,4,0,51,8,21,.381,0,0,,8,21,.381,.381,1,4,.250,2,6,8,5,3,0,4,10,17
1986,Mark Eaton,C,29,UTA,80,80,2551,277,589,.470,0,0,,277,589,.470,.470,122,202,.604,172,503,675,101,33,369,157,282,676
1986,Franklin Edwards,PG,26,LAC,73,19,1491,262,577,.454,1,9,.111,261,568,.460,.455,132,151,.874,24,62,86,259,89,4,137,87,657
1986,James Edwards,C,30,PHO,52,51,1314,318,587,.542,0,0,,318,587,.542,.542,212,302,.702,79,222,301,74,23,29,128,200,848
1986,Craig Ehlo,SG,24,HOU,36,0,199,36,84,.429,3,9,.333,33,75,.440,.446,23,29,.793,17,29,46,29,11,4,15,22,98
1986,Dale Ellis,SF,25,DAL,72,1,1086,193,470,.411,63,173,.364,130,297,.438,.478,59,82,.720,86,82,168,37,40,9,38,78,508
1986,Alex English*,SF,32,DEN,81,81,3024,951,1888,.504,1,5,.200,950,1883,.505,.504,511,593,.862,192,213,405,320,73,29,249,235,2414
1986,Julius Erving*,SF,35,PHI,74,74,2474,521,1085,.480,9,32,.281,512,1053,.486,.484,289,368,.785,169,201,370,248,113,82,214,196,1340
1986,Mike Evans,PG,30,DEN,81,1,1389,304,715,.425,39,176,.222,265,539,.492,.452,126,149,.846,30,71,101,177,61,1,124,159,773
1986,Patrick Ewing*,C,23,NYK,50,50,1771,386,814,.474,0,5,.000,386,809,.477,.474,226,306,.739,124,327,451,102,54,103,172,191,998
1986,Kenny Fields,SF,23,MIL,78,3,1120,204,398,.513,0,4,.000,204,394,.518,.513,91,132,.689,59,144,203,79,51,15,77,170,499
1986,Vern Fleming,PG,23,IND,80,77,2870,436,862,.506,1,6,.167,435,856,.508,.506,263,353,.745,102,284,386,505,131,5,208,230,1136
1986,Sleepy Floyd,PG,25,GSW,82,82,2764,510,1007,.506,39,119,.328,471,888,.530,.526,351,441,.796,76,221,297,746,157,16,290,199,1410
1986,Rod Foster,PG,25,PHO,48,0,704,85,218,.390,9,32,.281,76,186,.409,.411,23,32,.719,9,49,58,121,22,1,61,77,202
1986,World B. Free,SG,32,CLE,75,75,2535,652,1433,.455,71,169,.420,581,1264,.460,.480,379,486,.780,72,146,218,314,91,19,172,186,1754
1986,Bill Garnett,PF,25,IND,80,2,1197,112,239,.469,0,2,.000,112,237,.473,.469,116,162,.716,106,169,275,95,39,22,91,174,340
1986,George Gervin*,SG,33,CHI,82,75,2065,519,1100,.472,4,19,.211,515,1081,.476,.474,283,322,.879,78,137,215,144,49,23,161,210,1325
1986,Mike Gibson,PF,25,DET,32,0,161,20,51,.392,0,0,,20,51,.392,.392,8,11,.727,15,25,40,5,8,4,6,35,48
1986,Artis Gilmore*,C,36,SAS,71,71,2395,423,684,.618,0,1,.000,423,683,.619,.618,338,482,.701,166,434,600,102,39,108,186,239,1184
1986,Mike Glenn,SG,30,MIL,38,1,573,94,190,.495,0,0,,94,190,.495,.495,47,49,.959,4,53,57,39,9,3,18,42,235
1986,Georgi Glouchkov,PF,26,PHO,49,16,772,84,209,.402,1,1,1.000,83,208,.399,.404,70,122,.574,31,132,163,32,26,25,76,124,239
1986,Mike Gminski,C,26,NJN,81,78,2525,491,949,.517,0,1,.000,491,948,.518,.517,351,393,.893,206,462,668,133,56,71,140,163,1333
1986,Lancaster Gordon,SG,23,LAC,60,1,704,130,345,.377,7,28,.250,123,317,.388,.387,45,56,.804,24,44,68,60,33,10,62,91,312
1986,Stuart Gray,C,22,IND,67,3,423,54,108,.500,0,0,,54,108,.500,.500,47,74,.635,45,73,118,15,8,11,32,94,155
1986,A.C. Green,PF,22,LAL,82,1,1542,209,388,.539,1,6,.167,208,382,.545,.540,102,167,.611,160,221,381,54,49,49,99,229,521
1986,Ken Green,PF,26,NYK,7,0,72,13,27,.481,0,0,,13,27,.481,.481,5,9,.556,12,15,27,2,4,0,1,8,31
1986,Kenny Green,SF,21,TOT,41,0,453,83,192,.432,0,1,.000,83,191,.435,.432,35,49,.714,27,46,73,9,5,9,35,53,201
1986,Kenny Green,SF,21,WSB,20,0,221,44,101,.436,0,1,.000,44,100,.440,.436,21,26,.808,17,21,38,3,4,7,17,26,109
1986,Kenny Green,SF,21,PHI,21,0,232,39,91,.429,0,0,,39,91,.429,.429,14,23,.609,10,25,35,6,1,2,18,27,92
1986,Rickey Green,PG,31,UTA,80,44,2012,357,758,.471,5,29,.172,352,729,.483,.474,213,250,.852,32,103,135,411,106,6,132,130,932
1986,Sidney Green,PF,25,CHI,80,68,2307,407,875,.465,0,8,.000,407,867,.469,.465,262,335,.782,208,450,658,139,70,37,220,292,1076
1986,Dave Greenwood,PF,28,SAS,68,24,1910,198,388,.510,0,1,.000,198,387,.512,.510,142,184,.772,151,380,531,90,37,52,113,207,538
1986,Claude Gregory,PF,27,WSB,2,0,2,1,2,.500,0,0,,1,2,.500,.500,0,0,,2,0,2,0,1,0,2,1,2
1986,Ernie Grunfeld,SF,30,NYK,76,0,1402,148,355,.417,26,61,.426,122,294,.415,.454,90,108,.833,42,164,206,119,39,13,50,192,412
1986,Pétur Guðmundsson,C,27,LAL,8,2,128,20,37,.541,0,0,,20,37,.541,.541,18,27,.667,17,21,38,3,3,4,11,25,58
1986,Bob Hansen,SG,25,UTA,82,82,2032,299,628,.476,17,50,.340,282,578,.488,.490,95,132,.720,82,162,244,193,74,9,126,205,710
1986,Bill Hanzlik,SF,28,DEN,79,0,1982,331,741,.447,8,41,.195,323,700,.461,.452,318,405,.785,88,176,264,316,107,16,165,277,988
1986,Derek Harper,PG,24,DAL,79,39,2150,390,730,.534,12,51,.235,378,679,.557,.542,171,229,.747,75,151,226,416,153,23,144,166,963
1986,Steve Harris,SG,22,HOU,57,0,482,103,233,.442,1,5,.200,102,228,.447,.444,50,54,.926,25,32,57,50,21,4,34,55,257
1986,Scott Hastings,PF,25,ATL,62,0,650,65,159,.409,3,4,.750,62,155,.400,.418,60,70,.857,44,80,124,26,14,8,40,118,193
1986,Steve Hayes,C,30,UTA,58,0,397,39,87,.448,0,0,,39,87,.448,.448,11,36,.306,32,45,77,7,5,19,16,81,89
1986,Gerald Henderson,PG,30,SEA,82,82,2568,434,900,.482,18,52,.346,416,848,.491,.492,185,223,.830,89,98,187,487,138,11,184,230,1071
1986,Jerome Henderson,C,26,LAL,1,0,3,2,3,.667,0,0,,2,3,.667,.667,0,0,,0,1,1,0,0,0,0,1,4
1986,Carl Henry,SG,25,SAC,28,0,149,31,67,.463,4,10,.400,27,57,.474,.493,12,17,.706,8,11,19,4,5,0,9,11,78
1986,Rod Higgins,SF,26,TOT,30,0,332,39,106,.368,1,9,.111,38,97,.392,.373,19,27,.704,14,37,51,24,9,11,13,49,98
1986,Rod Higgins,SF,26,SEA,12,0,94,9,27,.333,1,4,.250,8,23,.348,.352,3,5,.600,3,9,12,6,2,1,4,11,22
1986,Rod Higgins,SF,26,SAS,11,0,128,18,40,.450,0,2,.000,18,38,.474,.450,11,16,.688,5,19,24,12,2,3,5,21,47
1986,Rod Higgins,SF,26,NJN,2,0,29,3,16,.188,0,2,.000,3,14,.214,.188,0,0,,3,5,8,1,1,4,2,6,6
1986,Rod Higgins,SF,26,CHI,5,0,81,9,23,.391,0,1,.000,9,22,.409,.391,5,6,.833,3,4,7,5,4,3,2,11,23
1986,Roy Hinson,SF,24,CLE,82,82,2834,621,1167,.532,0,4,.000,621,1163,.534,.532,364,506,.719,167,472,639,102,62,112,188,316,1606
1986,Craig Hodges,SG,25,MIL,66,66,1739,284,568,.500,73,162,.451,211,406,.520,.564,75,86,.872,39,78,117,229,74,2,89,157,716
1986,Michael Holton,PG-SG,24,TOT,28,0,512,77,175,.440,1,12,.083,76,163,.466,.443,28,44,.636,11,22,33,55,25,0,27,47,183
1986,Michael Holton,SG,24,PHO,4,0,65,4,20,.200,0,2,.000,4,18,.222,.200,4,6,.667,1,2,3,7,2,0,4,7,12
1986,Michael Holton,PG,24,CHI,24,0,447,73,155,.471,1,10,.100,72,145,.497,.474,24,38,.632,10,20,30,48,23,0,23,40,171
1986,Phil Hubbard,SF,29,CLE,23,21,640,93,198,.470,0,1,.000,93,197,.472,.470,76,112,.679,48,72,120,29,20,3,66,78,262
1986,Alfredrick Hughes,SG,23,SAS,68,0,866,152,372,.409,3,17,.176,149,355,.420,.413,49,84,.583,49,64,113,61,26,5,63,79,356
1986,Jay Humphries,PG,23,PHO,82,82,2733,352,735,.479,4,29,.138,348,706,.493,.482,197,257,.767,56,204,260,526,132,9,190,222,905
1986,Geoff Huston,PG,28,GSW,82,0,1208,140,273,.513,2,6,.333,138,267,.517,.516,63,92,.685,10,55,65,342,38,4,83,67,345
1986,Marc Iavaroni,PF,29,TOT,68,9,1014,110,244,.451,0,2,.000,110,242,.455,.451,76,115,.661,63,146,209,82,32,17,72,163,296
1986,Marc Iavaroni,PF,29,SAS,42,7,669,74,163,.454,0,2,.000,74,161,.460,.454,43,67,.642,42,90,132,53,22,14,51,109,191
1986,Marc Iavaroni,PF,29,UTA,26,2,345,36,81,.444,0,0,,36,81,.444,.444,33,48,.688,21,56,77,29,10,3,21,54,105
1986,Clemon Johnson,C,29,PHI,75,2,1069,105,223,.471,0,0,,105,223,.471,.471,51,81,.630,106,149,255,15,23,62,38,129,261
1986,Dennis Johnson*,PG,31,BOS,78,78,2732,482,1060,.455,6,42,.143,476,1018,.468,.458,243,297,.818,69,199,268,456,110,35,173,206,1213
1986,Eddie Johnson,SF,26,SAC,82,30,2514,623,1311,.475,4,20,.200,619,1291,.479,.477,280,343,.816,173,246,419,214,54,17,191,237,1530
1986,Eddie Johnson,SG,30,TOT,71,9,1477,284,621,.457,29,85,.341,255,536,.476,.481,112,155,.723,30,91,121,333,18,2,150,128,709
1986,Eddie Johnson,SG,30,ATL,39,5,862,155,328,.473,5,20,.250,150,308,.487,.480,79,110,.718,17,58,75,219,10,1,90,72,394
1986,Eddie Johnson,SG,30,CLE,32,4,615,129,293,.440,24,65,.369,105,228,.461,.481,33,45,.733,13,33,46,114,8,1,60,56,315
1986,Frank Johnson,PG,27,WSB,14,9,402,69,154,.448,0,3,.000,69,151,.457,.448,38,54,.704,7,21,28,76,11,1,29,30,176
1986,George Johnson,C,37,SEA,41,0,264,12,23,.522,0,0,,12,23,.522,.522,11,16,.688,26,34,60,13,6,37,14,46,35
1986,George Johnson,PF,29,WSB,2,0,7,1,3,.333,0,0,,1,3,.333,.333,2,2,1.000,1,1,2,0,0,0,1,1,4
1986,Ken Johnson,PF,23,POR,64,0,815,113,214,.528,0,0,,113,214,.528,.528,37,85,.435,90,153,243,19,13,22,59,147,263
1986,Magic Johnson*,PG,26,LAL,72,70,2578,483,918,.526,10,43,.233,473,875,.541,.532,378,434,.871,85,341,426,907,113,16,273,133,1354
1986,Marques Johnson,SG,29,LAC,75,75,2605,613,1201,.510,1,15,.067,612,1186,.516,.511,298,392,.760,156,260,416,283,107,50,183,214,1525
1986,Mickey Johnson,PF,33,NJN,79,4,1574,214,507,.422,5,24,.208,209,483,.433,.427,183,233,.785,98,234,332,217,67,25,165,248,616
1986,Steve Johnson,C,28,SAS,71,55,1828,362,573,.632,0,0,,362,573,.632,.632,259,373,.694,143,319,462,95,44,66,191,291,983
1986,Vinnie Johnson,SG,29,DET,79,12,1978,465,996,.467,2,13,.154,463,983,.471,.468,165,214,.771,119,107,226,269,80,23,88,180,1097
1986,Bobby Jones*,PF,34,PHI,70,42,1519,189,338,.559,0,1,.000,189,337,.561,.559,114,145,.786,49,120,169,126,48,50,90,159,492
1986,Caldwell Jones,C,35,POR,80,19,1437,126,254,.496,0,7,.000,126,247,.510,.496,124,150,.827,105,250,355,74,38,61,102,244,376
1986,Charles Jones,C,28,WSB,81,58,1609,129,254,.508,0,1,.000,129,253,.510,.508,54,86,.628,122,199,321,76,57,133,71,235,312
1986,Charles Jones,PF,24,PHO,43,18,742,75,164,.457,0,1,.000,75,163,.460,.457,50,98,.510,65,128,193,52,32,25,57,87,200
1986,Earl Jones,C,25,MIL,12,0,43,5,12,.417,0,0,,5,12,.417,.417,3,4,.750,4,6,10,4,0,1,7,13,13
1986,Edgar Jones,PF,29,CLE,53,6,1011,187,370,.505,7,23,.304,180,347,.519,.515,132,178,.742,71,136,207,45,30,38,64,142,513
1986,Ozell Jones,C,25,LAC,3,0,18,0,2,.000,0,0,,0,2,.000,.000,0,0,,0,2,2,0,2,1,3,5,0
1986,Michael Jordan*,SG,22,CHI,18,7,451,150,328,.457,3,18,.167,147,310,.474,.462,105,125,.840,23,41,64,53,37,21,45,46,408
1986,Yvon Joseph,C,28,NJN,1,0,5,0,0,,0,0,,0,0,,,2,2,1.000,0,0,0,0,0,0,0,1,2
1986,Harold Keeling,SG,22,DAL,20,0,75,17,39,.436,0,0,,17,39,.436,.436,10,14,.714,3,3,6,10,7,0,7,9,44
1986,Rich Kelley,C,32,SAC,37,0,324,28,49,.571,0,2,.000,28,47,.596,.571,18,22,.818,29,52,81,43,10,3,22,62,74
1986,Clark Kellogg,PF,24,IND,19,12,568,139,294,.473,4,13,.308,135,281,.480,.480,53,69,.768,51,117,168,57,28,8,61,59,335
1986,Jerome Kersey,SF,23,POR,79,2,1217,258,470,.549,0,6,.000,258,464,.556,.549,156,229,.681,137,156,293,83,85,32,113,208,672
1986,Albert King,SF,26,NJN,73,69,1998,438,961,.456,4,23,.174,434,938,.463,.458,167,203,.823,116,250,366,181,58,24,181,205,1047
1986,Greg Kite,C,24,BOS,64,2,464,34,91,.374,0,1,.000,34,90,.378,.374,15,39,.385,35,93,128,17,3,28,32,81,83
1986,Joe Kleine,C,24,SAC,80,18,1180,160,344,.465,0,0,,160,344,.465,.465,94,130,.723,113,260,373,46,24,34,107,224,414
1986,Jon Koncak,C,22,ATL,82,15,1695,263,519,.507,0,1,.000,263,518,.508,.507,156,257,.607,171,296,467,55,37,69,111,296,682
1986,Mitch Kupchak,PF,31,LAL,55,0,783,124,257,.482,0,1,.000,124,256,.484,.482,84,112,.750,69,122,191,17,12,7,64,102,332
1986,Bill Laimbeer,C,28,DET,82,82,2891,545,1107,.492,4,14,.286,541,1093,.495,.494,266,319,.834,305,770,1075,146,59,65,133,291,1360
1986,Jeff Lamp,SF,26,TOT,74,2,1321,245,514,.477,7,30,.233,238,484,.492,.483,111,133,.835,53,147,200,117,39,4,68,155,608
1986,Jeff Lamp,SF,26,MIL,44,1,701,109,243,.449,3,13,.231,106,230,.461,.455,55,64,.859,34,87,121,64,20,3,30,88,276
1986,Jeff Lamp,SF,26,SAS,30,1,620,136,271,.502,4,17,.235,132,254,.520,.509,56,69,.812,19,60,79,53,19,1,38,67,332
1986,Allen Leavell,PG,28,HOU,74,12,1190,212,458,.463,24,67,.358,188,391,.481,.489,135,158,.854,6,61,67,234,58,8,88,126,583
1986,Keith Lee,PF,23,CLE,58,38,1197,177,380,.466,2,9,.222,175,371,.472,.468,75,96,.781,116,235,351,67,29,37,78,204,431
1986,Ronnie Lester,PG,27,LAL,27,0,222,26,52,.500,0,3,.000,26,49,.531,.500,15,19,.789,0,10,10,54,9,3,42,27,67
1986,Fat Lever,PG,25,DEN,78,77,2616,468,1061,.441,12,38,.316,456,1023,.446,.447,132,182,.725,136,284,420,584,178,15,210,204,1080
1986,Cliff Levingston,PF,25,ATL,81,35,1945,294,551,.534,0,1,.000,294,550,.535,.534,164,242,.678,193,341,534,72,76,39,113,260,752
1986,Alton Lister,C,27,MIL,81,19,1812,318,577,.551,0,2,.000,318,575,.553,.551,160,266,.602,199,393,592,101,49,142,161,300,796
1986,Lewis Lloyd,SG,26,HOU,82,82,2444,592,1119,.529,3,15,.200,589,1104,.534,.530,199,236,.843,155,169,324,300,102,24,194,216,1386
1986,John Long,SG,29,DET,62,30,1176,264,548,.482,3,16,.188,261,532,.491,.484,89,104,.856,47,51,98,82,41,13,59,92,620
1986,John Lucas,PG,32,HOU,65,65,2120,365,818,.446,45,146,.308,320,672,.476,.474,231,298,.775,33,110,143,571,77,5,149,124,1006
1986,Maurice Lucas,PF,33,LAL,77,8,1750,302,653,.462,1,2,.500,301,651,.462,.463,180,230,.783,164,402,566,84,45,24,121,253,785
1986,Kyle Macy,PG,28,CHI,82,79,2426,286,592,.483,58,141,.411,228,451,.506,.532,73,90,.811,41,137,178,446,81,11,117,201,703
1986,Rick Mahorn,PF,27,DET,80,12,1442,157,345,.455,0,1,.000,157,344,.456,.455,81,119,.681,121,291,412,64,40,61,109,261,395
1986,Jeff Malone,SG,24,WSB,80,80,2992,735,1522,.483,3,17,.176,732,1505,.486,.484,322,371,.868,66,222,288,191,70,12,168,180,1795
1986,Karl Malone*,PF,22,UTA,81,76,2475,504,1016,.496,0,2,.000,504,1014,.497,.496,195,405,.481,174,544,718,236,105,44,279,295,1203
1986,Moses Malone*,C,30,PHI,74,74,2706,571,1246,.458,0,1,.000,571,1245,.459,.458,617,784,.787,339,533,872,90,67,71,261,194,1759
1986,Pace Mannion,SF,25,UTA,57,0,673,97,214,.453,8,42,.190,89,172,.517,.472,53,82,.646,26,56,82,55,32,5,41,68,255
1986,Bill Martin,SF,23,IND,66,0,691,143,298,.480,0,8,.000,143,290,.493,.480,46,54,.852,42,60,102,52,21,7,58,108,332
1986,Brian Martin,SF-PF,23,TOT,8,0,21,3,7,.429,0,0,,3,7,.429,.429,0,2,.000,1,3,4,0,0,1,2,7,6
1986,Brian Martin,PF,23,SEA,3,0,7,1,2,.500,0,0,,1,2,.500,.500,0,0,,1,3,4,0,0,1,2,2,2
1986,Brian Martin,SF,23,POR,5,0,14,2,5,.400,0,0,,2,5,.400,.400,0,2,.000,0,0,0,0,0,0,0,5,4
1986,Wes Matthews,PG,26,SAS,75,46,1853,320,603,.531,4,25,.160,316,578,.547,.534,173,211,.820,30,101,131,476,87,32,232,168,817
1986,Cedric Maxwell,SF,30,LAC,76,72,2458,314,661,.475,0,3,.000,314,658,.477,.475,447,562,.795,241,383,624,215,61,29,206,252,1075
1986,Bob McAdoo*,C,34,PHI,29,0,609,116,251,.462,0,0,,116,251,.462,.462,62,81,.765,25,78,103,35,10,18,49,64,294
1986,Dwayne McClain,SF,22,IND,45,4,461,69,180,.383,1,9,.111,68,171,.398,.386,18,35,.514,14,16,30,67,38,4,40,61,157
1986,Tim McCormick,C,23,SEA,77,42,1705,253,444,.570,1,2,.500,252,442,.570,.571,174,244,.713,140,263,403,83,19,28,110,219,681
1986,Rodney McCray,SF,24,HOU,82,82,2610,338,629,.537,0,3,.000,338,626,.540,.537,171,222,.770,159,361,520,292,50,58,130,197,847
1986,Xavier McDaniel,SF,22,SEA,82,80,2706,576,1176,.490,2,10,.200,574,1166,.492,.491,250,364,.687,307,348,655,193,101,37,248,305,1404
1986,Ben McDonald,SF,23,CLE,21,0,266,28,58,.483,0,1,.000,28,57,.491,.483,5,8,.625,15,23,38,9,7,1,10,30,61
1986,Hank McDowell,PF,26,HOU,22,0,204,24,42,.571,0,1,.000,24,41,.585,.571,17,25,.680,12,37,49,6,1,3,10,25,65
1986,Mike McGee,SF,26,LAL,71,19,1213,252,544,.463,41,114,.360,211,430,.491,.501,42,64,.656,51,89,140,83,53,7,70,131,587
1986,Kevin McHale*,PF,28,BOS,68,62,2397,561,978,.574,0,0,,561,978,.574,.574,326,420,.776,171,380,551,181,29,134,149,192,1448
1986,Kevin McKenna,SG,27,WSB,30,1,430,61,166,.367,27,75,.360,34,91,.374,.449,25,30,.833,9,27,36,23,29,2,18,54,174
1986,Billy McKinney,PG,30,CHI,9,0,83,10,23,.435,0,0,,10,23,.435,.435,2,2,1.000,1,4,5,13,3,0,2,9,22
1986,Tom McMillen,C,33,WSB,56,1,863,131,285,.460,0,3,.000,131,282,.465,.460,64,79,.810,44,69,113,35,9,10,34,85,326
1986,Chris McNealy,PF,24,NYK,30,6,627,70,144,.486,0,0,,70,144,.486,.486,31,47,.660,62,141,203,41,38,12,35,88,171
1986,Dirk Minniefield,PG,25,CLE,76,2,1131,167,347,.481,10,37,.270,157,310,.506,.496,73,93,.785,43,88,131,269,65,1,108,165,417
1986,Mike Mitchell,SF,30,SAS,82,82,2970,802,1697,.473,0,12,.000,802,1685,.476,.473,317,392,.809,134,275,409,188,56,25,184,175,1921
1986,Paul Mokeski,C,29,MIL,45,0,521,59,139,.424,0,0,,59,139,.424,.424,25,34,.735,36,103,139,30,6,6,25,92,143
1986,Sidney Moncrief*,PG,28,MIL,73,72,2567,470,962,.489,33,103,.320,437,859,.509,.506,498,580,.859,115,219,334,357,103,18,174,178,1471
1986,Johnny Moore,PG,27,SAS,28,23,856,150,303,.495,4,22,.182,146,281,.520,.502,59,86,.686,25,61,86,252,70,6,81,78,363
1986,Perry Moss,PG,27,TOT,72,0,1012,116,292,.397,7,32,.219,109,260,.419,.409,65,89,.730,34,81,115,108,56,15,79,132,304
1986,Perry Moss,PG,27,WSB,12,0,160,21,53,.396,2,7,.286,19,46,.413,.415,11,15,.733,9,16,25,19,6,3,18,26,55
1986,Perry Moss,PG,27,PHI,60,0,852,95,239,.397,5,25,.200,90,214,.421,.408,54,74,.730,25,65,90,89,50,12,61,106,249
1986,Chris Mullin*,SG,22,GSW,55,30,1391,287,620,.463,5,27,.185,282,593,.476,.467,189,211,.896,42,73,115,105,70,23,75,130,768
1986,Jay Murphy,SF,23,LAC,14,0,100,16,45,.356,0,2,.000,16,43,.372,.356,9,14,.643,7,8,15,3,4,3,5,12,41
1986,Larry Nance,PF,26,PHO,73,69,2484,582,1001,.581,0,8,.000,582,993,.586,.581,310,444,.698,169,449,618,240,70,130,210,247,1474
1986,Calvin Natt,PF,29,DEN,69,62,2007,469,930,.504,2,6,.333,467,924,.505,.505,278,347,.801,125,311,436,164,58,13,130,143,1218
1986,Chuck Nevitt,C,26,TOT,29,0,126,15,43,.349,0,0,,15,43,.349,.349,19,26,.731,13,19,32,7,4,19,12,35,49
1986,Chuck Nevitt,C,26,LAL,4,0,25,3,11,.273,0,0,,3,11,.273,.273,4,6,.667,3,4,7,2,2,2,5,6,10
1986,Chuck Nevitt,C,26,DET,25,0,101,12,32,.375,0,0,,12,32,.375,.375,15,20,.750,10,15,25,5,2,17,7,29,39
1986,Kurt Nimphius,PF,27,TOT,80,66,2226,351,694,.506,0,3,.000,351,691,.508,.506,194,262,.740,152,301,453,62,33,105,120,267,896
1986,Kurt Nimphius,PF,27,DAL,13,4,280,37,72,.514,0,1,.000,37,71,.521,.514,17,29,.586,23,37,60,14,3,12,13,38,91
1986,Kurt Nimphius,PF,27,LAC,67,62,1946,314,622,.505,0,2,.000,314,620,.506,.505,177,233,.760,129,264,393,48,30,93,107,229,805
1986,Norm Nixon,PG,30,LAC,67,62,2138,403,921,.438,42,121,.347,361,800,.451,.460,131,162,.809,45,135,180,576,84,3,190,143,979
1986,Mike O'Koren,SF,27,NJN,67,11,1031,160,336,.476,7,27,.259,153,309,.495,.487,23,39,.590,33,102,135,118,29,9,54,134,350
1986,Charles Oakley,PF,22,CHI,77,30,1772,281,541,.519,0,3,.000,281,538,.522,.519,178,269,.662,255,409,664,133,68,30,175,250,740
1986,Hakeem Olajuwon*,C,23,HOU,68,68,2467,625,1188,.526,0,0,,625,1188,.526,.526,347,538,.645,333,448,781,137,134,231,195,271,1597
1986,Mark Olberding,PF,29,SAC,81,64,2157,225,403,.558,0,2,.000,225,401,.561,.558,162,210,.771,113,310,423,266,43,23,148,276,612
1986,Jawann Oldham,C,28,CHI,52,47,1276,167,323,.517,0,1,.000,167,322,.519,.517,53,91,.582,112,194,306,37,28,134,86,206,387
1986,Louis Orr,SF,27,NYK,74,64,2237,330,741,.445,0,4,.000,330,737,.448,.445,218,278,.784,123,189,312,179,61,26,118,177,878
1986,Robert Parish*,C,32,BOS,81,80,2567,530,966,.549,0,0,,530,966,.549,.549,245,335,.731,246,524,770,145,65,116,187,215,1305
1986,Jim Paxson,SG,28,POR,75,31,1931,372,792,.470,20,62,.323,352,730,.482,.482,217,244,.889,42,106,148,278,94,5,112,156,981
1986,John Paxson,PG,25,CHI,75,3,1570,153,328,.466,15,50,.300,138,278,.496,.489,74,92,.804,18,76,94,274,55,2,63,172,395
1986,Sam Perkins,PF,24,DAL,80,79,2626,458,910,.503,11,33,.333,447,877,.510,.509,307,377,.814,195,490,685,153,75,94,145,212,1234
1986,Jim Petersen,PF,23,HOU,82,20,1664,196,411,.477,0,3,.000,196,408,.480,.477,113,160,.706,149,247,396,85,38,54,84,231,505
1986,Michael Phelps,SG,24,SEA,70,18,880,117,286,.409,1,12,.083,116,274,.423,.411,44,74,.595,29,60,89,71,45,1,62,86,279
1986,Ricky Pierce,SG,26,MIL,81,8,2147,429,798,.538,3,23,.130,426,775,.550,.539,266,310,.858,94,137,231,177,83,6,107,252,1127
1986,Ed Pinckney,SF,22,PHO,80,24,1602,255,457,.558,0,2,.000,255,455,.560,.558,171,254,.673,95,213,308,90,71,37,148,190,681
1986,Charles Pittman,PF,27,PHO,69,17,1132,127,218,.583,0,0,,127,218,.583,.583,99,141,.702,99,147,246,58,37,23,107,140,353
1986,David Pope,SF,23,SEA,11,0,74,9,20,.450,1,1,1.000,8,19,.421,.475,2,4,.500,6,5,11,4,2,1,2,11,21
1986,Ben Poquette,PF,30,CLE,81,3,1496,166,348,.477,2,10,.200,164,338,.485,.480,72,100,.720,121,252,373,78,33,32,68,187,406
1986,Terry Porter,PG,22,POR,79,3,1214,212,447,.474,13,42,.310,199,405,.491,.489,125,155,.806,35,82,117,198,81,1,106,136,562
1986,Paul Pressey,SF,27,MIL,80,80,2704,411,843,.488,8,44,.182,403,799,.504,.492,316,392,.806,127,272,399,623,168,71,240,247,1146
1986,Kurt Rambis,PF,27,LAL,74,74,1573,160,269,.595,0,0,,160,269,.595,.595,88,122,.721,156,361,517,69,66,33,97,198,408
1986,Kelvin Ransey,PG,27,NJN,79,15,1504,231,505,.457,3,24,.125,228,481,.474,.460,121,148,.818,34,82,116,252,51,4,114,128,586
1986,Blair Rasmussen,C,23,DEN,48,1,330,61,150,.407,0,0,,61,150,.407,.407,31,39,.795,37,60,97,16,3,10,40,63,153
1986,Robert Reid,SF,30,HOU,82,5,2157,409,881,.464,6,33,.182,403,848,.475,.468,162,214,.757,67,234,301,222,91,16,96,231,986
1986,Jerry Reynolds,SF,23,MIL,55,8,508,72,162,.444,1,2,.500,71,160,.444,.448,58,104,.558,37,43,80,86,43,19,52,57,203
1986,Clint Richardson,SG,29,IND,82,61,2224,335,736,.455,1,9,.111,334,727,.459,.456,123,147,.837,69,182,251,372,58,8,136,153,794
1986,Micheal Ray Richardson,PG,30,NJN,47,39,1604,296,661,.448,4,27,.148,292,634,.461,.451,141,179,.788,77,173,250,340,125,11,150,163,737
1986,Doc Rivers,PG,24,ATL,53,50,1571,220,464,.474,0,16,.000,220,448,.491,.474,172,283,.608,49,113,162,443,120,13,141,185,612
1986,Fred Roberts,PF,25,UTA,58,0,469,74,167,.443,1,2,.500,73,165,.442,.446,67,87,.770,31,49,80,27,8,6,53,72,216
1986,Alvin Robertson,SG,23,SAS,82,82,2878,562,1093,.514,8,29,.276,554,1064,.521,.518,260,327,.795,184,332,516,448,301,40,256,296,1392
1986,Rick Robey,C,30,PHO,46,1,629,72,191,.377,0,3,.000,72,188,.383,.377,33,48,.688,40,108,148,58,19,5,66,92,177
1986,Cliff Robinson,SF,25,WSB,78,78,2563,595,1255,.474,1,4,.250,594,1251,.475,.475,269,353,.762,180,500,680,186,98,44,206,217,1460
1986,Tree Rollins,C,30,ATL,74,61,1781,173,347,.499,0,1,.000,173,346,.500,.499,69,90,.767,131,327,458,41,38,167,91,239,415
1986,Dan Roundfield,PF,32,WSB,79,21,2321,322,660,.488,0,6,.000,322,654,.492,.488,273,362,.754,210,432,642,167,36,51,187,194,917
1986,Derrick Rowland,SG,26,MIL,2,0,9,1,3,.333,0,0,,1,3,.333,.333,1,2,.500,0,1,1,1,0,0,0,1,3
1986,Jeff Ruland,PF,27,WSB,30,24,1114,212,383,.554,0,4,.000,212,379,.559,.554,145,200,.725,107,213,320,159,23,25,121,100,569
1986,Walker Russell,PG,25,DET,1,0,2,0,1,.000,0,0,,0,1,.000,.000,0,0,,0,0,0,1,0,0,0,0,0
1986,Ralph Sampson*,PF,25,HOU,79,76,2864,624,1280,.488,2,15,.133,622,1265,.492,.488,241,376,.641,258,621,879,283,99,129,285,308,1491
1986,Mike Sanders,SF,25,PHO,82,5,1644,347,676,.513,3,15,.200,344,661,.520,.516,208,257,.809,104,169,273,150,76,31,143,236,905
1986,Danny Schayes,C,26,DEN,80,13,1654,221,440,.502,0,1,.000,221,439,.503,.502,216,278,.777,154,285,439,79,42,63,105,298,658
1986,Detlef Schrempf,SF,23,DAL,64,12,969,142,315,.451,3,7,.429,139,308,.451,.456,110,152,.724,70,128,198,88,23,10,84,166,397
1986,Byron Scott,SG,24,LAL,76,62,2190,507,989,.513,22,61,.361,485,928,.523,.524,138,176,.784,55,134,189,164,85,15,110,167,1174
1986,Carey Scurry,SF,23,UTA,78,0,1168,142,301,.472,1,11,.091,141,290,.486,.473,78,126,.619,97,145,242,85,78,66,96,171,363
1986,Lonnie Shelton,PF,30,CLE,44,1,682,92,188,.489,0,2,.000,92,186,.495,.489,14,16,.875,38,105,143,61,21,4,48,128,198
1986,Purvis Short,SF,28,GSW,64,63,2427,633,1313,.482,15,49,.306,618,1264,.489,.488,351,406,.865,126,203,329,237,92,22,184,229,1632
1986,Jerry Sichting,PG,29,BOS,82,7,1596,235,412,.570,6,16,.375,229,396,.578,.578,61,66,.924,27,77,104,188,50,0,73,118,537
1986,Jack Sikma*,C,30,SEA,80,78,2790,508,1100,.462,0,13,.000,508,1087,.467,.462,355,411,.864,146,602,748,301,92,73,214,293,1371
1986,Derek Smith,SG,24,LAC,11,9,339,100,181,.552,1,2,.500,99,179,.553,.555,58,84,.690,20,21,41,31,9,13,33,35,259
1986,Larry Smith,PF,28,GSW,77,74,2441,314,586,.536,0,1,.000,314,585,.537,.536,112,227,.493,384,472,856,95,62,50,135,286,740
1986,Mike Smrek,C,23,CHI,38,5,408,46,122,.377,0,2,.000,46,120,.383,.377,16,29,.552,46,64,110,19,6,23,29,95,108
1986,Ricky Sobers,SG,33,SEA,78,0,1279,240,541,.444,13,43,.302,227,498,.456,.456,110,125,.880,29,70,99,180,44,2,85,139,603
1986,Rory Sparrow,PG,27,NYK,74,74,2344,345,723,.477,5,20,.250,340,703,.484,.481,101,127,.795,50,120,170,472,85,14,154,182,796
1986,Larry Spriggs,SF,26,LAL,43,7,471,88,192,.458,0,1,.000,88,191,.461,.458,38,49,.776,28,53,81,49,18,9,54,78,214
1986,Terence Stansbury,SG,24,IND,74,17,1331,191,441,.433,9,53,.170,182,388,.469,.443,107,132,.811,29,110,139,206,59,8,139,200,498
1986,Steve Stipanovich,C,25,IND,79,65,2397,416,885,.470,2,10,.200,414,875,.473,.471,242,315,.768,173,450,623,206,75,69,146,261,1076
1986,Alex Stivrins,SF,23,SEA,3,0,14,1,4,.250,0,0,,1,4,.250,.250,1,4,.250,3,0,3,1,0,0,3,2,3
1986,John Stockton*,PG,23,UTA,82,38,1935,228,466,.489,2,15,.133,226,451,.501,.491,172,205,.839,33,146,179,610,157,10,168,227,630
1986,Greg Stokes,PF,22,PHI,31,13,350,56,119,.471,0,1,.000,56,118,.475,.471,14,21,.667,27,30,57,17,14,11,19,56,126
1986,Jon Sundvold,PG,24,SAS,70,4,1150,220,476,.462,21,60,.350,199,416,.478,.484,39,48,.813,22,58,80,261,34,0,85,110,500
1986,Terry Teagle,SG,25,GSW,82,52,2158,475,958,.496,4,25,.160,471,933,.505,.498,211,265,.796,96,139,235,115,71,34,136,241,1165
1986,Reggie Theus,SG,28,SAC,82,82,2919,546,1137,.480,6,35,.171,540,1102,.490,.483,405,490,.827,73,231,304,788,112,20,327,231,1503
1986,Peter Thibeaux,SF,24,GSW,42,8,531,100,233,.429,2,5,.400,98,228,.430,.433,29,48,.604,28,47,75,28,23,15,39,82,231
1986,David Thirdkill,PF,25,BOS,49,0,385,54,110,.491,0,1,.000,54,109,.495,.491,55,88,.625,27,43,70,15,11,3,19,55,163
1986,Isiah Thomas*,PG,24,DET,77,77,2790,609,1248,.488,26,84,.310,583,1164,.501,.498,365,462,.790,83,194,277,830,171,20,289,245,1609
1986,Jim Thomas,SG,25,LAC,6,0,69,6,15,.400,0,0,,6,15,.400,.400,1,2,.500,3,5,8,12,5,1,9,12,13
1986,Bernard Thompson,SG,23,PHO,61,20,1281,195,399,.489,0,2,.000,195,397,.491,.489,127,157,.809,58,83,141,132,51,10,90,151,517
1986,LaSalle Thompson,C,24,SAC,80,64,2377,411,794,.518,0,1,.000,411,793,.518,.518,202,276,.732,252,518,770,168,71,109,184,295,1024
1986,Mychal Thompson,C,31,POR,82,78,2569,503,1011,.498,0,0,,503,1011,.498,.498,198,309,.641,181,427,608,176,76,35,196,267,1204
1986,Paul Thompson,SF,24,PHI,23,8,432,70,194,.361,2,12,.167,68,182,.374,.366,37,43,.860,27,36,63,24,15,17,30,49,179
1986,Bob Thornton,PF,23,NYK,71,23,1323,125,274,.456,0,0,,125,274,.456,.456,86,162,.531,113,177,290,43,30,7,83,209,336
1986,Otis Thorpe,PF,23,SAC,75,18,1675,289,492,.587,0,0,,289,492,.587,.587,164,248,.661,137,283,420,84,35,34,123,233,742
1986,Sedale Threatt,SG,24,PHI,70,27,1754,310,684,.453,1,24,.042,309,660,.468,.454,75,90,.833,21,100,121,193,93,5,102,157,696
1986,Wayman Tisdale,PF,21,IND,81,60,2277,516,1002,.515,0,2,.000,516,1000,.516,.515,160,234,.684,191,393,584,79,32,44,188,290,1192
1986,Andrew Toney,SG,28,PHI,6,0,84,11,36,.306,0,2,.000,11,34,.324,.306,3,8,.375,2,3,5,12,2,0,7,8,25
1986,Sedric Toney,PG,23,TOT,13,0,230,28,66,.424,3,10,.300,25,56,.446,.447,21,31,.677,3,22,25,26,6,0,22,24,80
1986,Sedric Toney,PG,23,ATL,3,0,24,2,7,.286,0,0,,2,7,.286,.286,1,1,1.000,0,2,2,0,1,0,3,6,5
1986,Sedric Toney,PG,23,PHO,10,0,206,26,59,.441,3,10,.300,23,49,.469,.466,20,30,.667,3,20,23,26,5,0,19,18,75
1986,Kelly Tripucka,SF,26,DET,81,81,2626,615,1236,.498,12,25,.480,603,1211,.498,.502,380,444,.856,116,232,348,265,93,10,183,167,1622
1986,Trent Tucker,SG,26,NYK,77,23,1788,349,740,.472,41,91,.451,308,649,.475,.499,79,100,.790,70,99,169,192,65,8,70,167,818
1986,Elston Turner,SG,26,DEN,73,0,1324,165,379,.435,0,9,.000,165,370,.446,.435,39,53,.736,64,137,201,165,70,6,80,150,369
1986,Jeff Turner,PF,23,NJN,53,1,650,84,171,.491,0,1,.000,84,170,.494,.491,58,78,.744,45,92,137,14,21,3,49,125,226
1986,Melvin Turpin,C,25,CLE,80,69,2292,456,838,.544,0,4,.000,456,834,.547,.544,185,228,.811,182,374,556,55,65,106,134,260,1097
1986,Terry Tyler,SF,29,SAC,71,52,1651,295,649,.455,0,3,.000,295,646,.457,.455,84,112,.750,109,204,313,94,64,108,94,159,674
1986,Darnell Valentine,PG,26,TOT,62,29,1217,161,388,.415,4,14,.286,157,374,.420,.420,130,175,.743,32,93,125,246,72,2,115,123,456
1986,Darnell Valentine,PG,26,POR,28,27,734,92,206,.447,1,3,.333,91,203,.448,.449,71,100,.710,20,52,72,139,49,1,58,78,256
1986,Darnell Valentine,PG,26,LAC,34,2,483,69,182,.379,3,11,.273,66,171,.386,.387,59,75,.787,12,41,53,107,23,1,57,45,200
1986,Kiki Vandeweghe,SF,27,POR,79,76,2791,719,1332,.540,1,8,.125,718,1324,.542,.540,523,602,.869,92,124,216,187,54,17,177,161,1962
1986,Nick Vanos,C,22,PHO,11,0,202,23,72,.319,0,0,,23,72,.319,.319,8,23,.348,21,39,60,16,2,5,20,34,54
1986,Pete Verhoeven,PF,26,GSW,61,5,749,90,167,.539,1,2,.500,89,165,.539,.542,25,43,.581,65,95,160,29,29,17,30,141,206
1986,Jay Vincent,PF,26,DAL,80,3,1994,442,919,.481,0,3,.000,442,916,.483,.481,222,274,.810,107,261,368,180,66,21,145,193,1106
1986,Sam Vincent,SG,22,BOS,57,0,432,59,162,.364,1,4,.250,58,158,.367,.367,65,70,.929,11,37,48,69,17,4,49,59,184
1986,Danny Vranes,SF,27,SEA,80,19,1569,131,284,.461,0,4,.000,131,280,.468,.461,39,75,.520,115,166,281,68,63,31,58,218,301
1986,Granville Waiters,C,25,HOU,43,0,156,13,39,.333,0,1,.000,13,38,.342,.333,1,6,.167,15,13,28,8,4,10,11,30,27
1986,Darrell Walker,PG,24,NYK,81,35,2023,324,753,.430,0,10,.000,324,743,.436,.430,190,277,.686,100,120,220,337,146,36,192,216,838
1986,Bill Walton*,C,33,BOS,80,2,1546,231,411,.562,0,0,,231,411,.562,.562,144,202,.713,136,408,544,165,38,106,151,210,606
1986,Bryan Warrick,PG,26,TOT,36,5,685,85,182,.467,3,12,.250,82,170,.482,.475,54,68,.794,10,59,69,115,27,2,53,79,227
1986,Bryan Warrick,PG,26,MIL,5,0,27,4,10,.400,1,2,.500,3,8,.375,.450,1,1,1.000,0,3,3,6,2,0,5,3,10
1986,Bryan Warrick,PG,26,IND,31,5,658,81,172,.471,2,10,.200,79,162,.488,.477,53,67,.791,10,56,66,109,25,2,48,76,217
1986,Spud Webb,PG,22,ATL,79,8,1229,199,412,.483,2,11,.182,197,401,.491,.485,216,275,.785,27,96,123,337,82,5,159,164,616
1986,Scott Wedman,SF,33,BOS,79,19,1402,286,605,.473,17,48,.354,269,557,.483,.487,45,68,.662,66,126,192,83,38,22,54,127,634
1986,Bill Wennington,C,22,DAL,56,3,562,72,153,.471,0,4,.000,72,149,.483,.471,45,62,.726,32,100,132,21,11,22,21,83,189
1986,Mark West,C,25,CLE,67,26,1172,113,209,.541,0,0,,113,209,.541,.541,54,103,.524,97,225,322,20,27,62,91,235,280
1986,Ennis Whatley,PG,23,TOT,14,1,107,15,35,.429,0,0,,15,35,.429,.429,5,10,.500,4,10,14,23,5,1,10,10,35
1986,Ennis Whatley,PG,23,CLE,8,0,66,9,19,.474,0,0,,9,19,.474,.474,4,7,.571,2,5,7,13,5,0,6,8,22
1986,Ennis Whatley,PG,23,WSB,4,0,27,5,14,.357,0,0,,5,14,.357,.357,1,3,.333,2,5,7,7,0,1,0,1,11
1986,Ennis Whatley,PG,23,SAS,2,1,14,1,2,.500,0,0,,1,2,.500,.500,0,0,,0,0,0,3,0,0,4,1,2
1986,Rory White,SF,26,LAC,75,30,1761,355,684,.519,1,9,.111,354,675,.524,.520,164,222,.739,82,99,181,74,74,8,95,161,875
1986,Willie White,SG,23,DEN,43,4,343,74,168,.440,6,21,.286,68,147,.463,.458,19,23,.826,17,27,44,53,18,2,25,24,173
1986,Jerome Whitehead,C,29,GSW,81,3,1079,126,294,.429,0,0,,126,294,.429,.429,60,97,.619,94,234,328,19,18,19,64,176,312
1986,Mitchell Wiggins,SG,26,HOU,78,0,1198,222,489,.454,1,12,.083,221,477,.463,.455,86,118,.729,87,72,159,101,59,5,62,155,531
1986,Jamaal Wilkes*,SF,32,LAC,13,1,195,26,65,.400,1,3,.333,25,62,.403,.408,22,27,.815,13,16,29,15,7,2,16,19,75
1986,Dominique Wilkins*,SF,26,ATL,78,78,3049,888,1897,.468,13,70,.186,875,1827,.479,.472,577,705,.818,261,357,618,206,138,49,251,170,2366
1986,Gerald Wilkins,SG,22,NYK,81,53,2025,437,934,.468,7,25,.280,430,909,.473,.472,132,237,.557,92,116,208,161,68,9,157,155,1013
1986,Jeff Wilkins,C,30,TOT,75,4,1126,147,374,.393,0,0,,147,374,.393,.393,58,93,.624,74,198,272,46,11,21,52,157,352
1986,Jeff Wilkins,C,30,UTA,48,0,604,96,240,.400,0,0,,96,240,.400,.400,30,47,.638,40,105,145,28,3,11,32,86,222
1986,Jeff Wilkins,C,30,SAS,27,4,522,51,134,.381,0,0,,51,134,.381,.381,28,46,.609,34,93,127,18,8,10,20,71,130
1986,Buck Williams,PF,25,NJN,82,82,3070,500,956,.523,0,2,.000,500,954,.524,.523,301,445,.676,329,657,986,131,73,96,244,294,1301
1986,Freeman Williams,SG,29,WSB,9,0,110,25,67,.373,7,14,.500,18,53,.340,.425,12,17,.706,4,8,12,7,7,1,13,10,69
1986,Gus Williams,PG,32,WSB,77,67,2284,434,1013,.428,30,116,.259,404,897,.450,.443,138,188,.734,52,114,166,453,96,15,160,113,1036
1986,Guy Williams,PF,25,GSW,5,0,25,2,5,.400,0,0,,2,5,.400,.400,3,6,.500,0,6,6,0,1,2,0,7,7
1986,Herb Williams,C,27,IND,78,74,2770,627,1275,.492,1,12,.083,626,1263,.496,.492,294,403,.730,172,538,710,174,50,184,210,244,1549
1986,Pete Williams,PF,20,DEN,53,11,573,67,111,.604,0,0,,67,111,.604,.604,17,40,.425,47,99,146,14,19,23,19,68,151
1986,Ray Williams,PG,31,TOT,47,21,827,117,306,.382,6,19,.316,111,287,.387,.392,115,126,.913,35,51,86,187,61,4,101,124,355
1986,Ray Williams,PG,31,ATL,19,13,367,57,143,.399,4,11,.364,53,132,.402,.413,41,48,.854,19,26,45,67,28,1,41,48,159
1986,Ray Williams,PG,31,SAS,23,8,397,50,131,.382,2,6,.333,48,125,.384,.389,62,64,.969,13,24,37,111,28,3,51,64,164
1986,Ray Williams,PG,31,NJN,5,0,63,10,32,.313,0,2,.000,10,30,.333,.313,12,14,.857,3,1,4,9,5,0,9,12,32
1986,Sly Williams,SF,28,BOS,6,0,54,5,21,.238,0,4,.000,5,17,.294,.238,7,12,.583,7,8,15,2,1,1,7,15,17
1986,Kevin Willis,PF,23,ATL,82,59,2300,419,811,.517,0,6,.000,419,805,.520,.517,172,263,.654,243,461,704,45,66,44,177,294,1010
1986,Voise Winters,SF,23,PHI,4,0,17,3,13,.231,0,1,.000,3,12,.250,.231,0,0,,1,2,3,0,1,0,2,1,6
1986,Randy Wittman,SG,26,ATL,81,79,2760,467,881,.530,5,16,.313,462,865,.534,.533,104,135,.770,51,119,170,306,81,14,114,118,1043
1986,Al Wood,SG,27,SEA,78,34,1749,355,817,.435,5,37,.135,350,780,.449,.438,187,239,.782,80,164,244,114,57,19,107,171,902
1986,Leon Wood,PG,23,TOT,68,1,1198,184,466,.395,41,114,.360,143,352,.406,.439,123,155,.794,25,65,90,182,34,0,74,70,532
1986,Leon Wood,PG,23,PHI,29,1,455,57,136,.419,13,29,.448,44,107,.411,.467,27,34,.794,9,18,27,75,14,0,7,24,154
1986,Leon Wood,PG,23,WSB,39,0,743,127,330,.385,28,85,.329,99,245,.404,.427,96,121,.793,16,47,63,107,20,0,67,46,378
1986,Mike Woodson,SG,27,SAC,81,51,2417,510,1073,.475,2,13,.154,508,1060,.479,.476,242,289,.837,94,132,226,197,92,37,145,215,1264
1986,Orlando Woolridge,SF,26,CHI,70,59,2248,540,1090,.495,4,23,.174,536,1067,.502,.497,364,462,.788,150,200,350,213,49,47,174,186,1448
1986,James Worthy*,SF,24,LAL,75,73,2454,629,1086,.579,0,13,.000,629,1073,.586,.579,242,314,.771,136,251,387,201,82,77,149,195,1500
1986,Danny Young,PG,23,SEA,82,29,1901,227,449,.506,24,74,.324,203,375,.541,.532,90,106,.849,29,91,120,303,110,9,92,113,568
1986,Michael Young,SF,25,PHI,2,0,2,0,2,.000,0,0,,0,2,.000,.000,0,0,,0,0,0,0,0,0,0,0,0
1987,Kareem Abdul-Jabbar*,C,39,LAL,78,78,2441,560,993,.564,1,3,.333,559,990,.565,.564,245,343,.714,152,371,523,203,49,97,186,245,1366
1987,Alvan Adams,C,32,PHO,68,40,1690,311,618,.503,0,1,.000,311,617,.504,.503,134,170,.788,91,247,338,223,62,37,139,207,756
1987,Michael Adams,PG,24,WSB,63,0,1303,160,393,.407,28,102,.275,132,291,.454,.443,105,124,.847,38,85,123,244,85,6,81,88,453
1987,Rafael Addison,SF,22,PHO,62,12,711,146,331,.441,16,50,.320,130,281,.463,.465,51,64,.797,41,65,106,45,27,7,54,75,359
1987,Mark Aguirre,SF,27,DAL,80,80,2663,787,1590,.495,53,150,.353,734,1440,.510,.512,429,557,.770,181,246,427,254,84,30,217,243,2056
1987,Danny Ainge,SG,27,BOS,71,66,2499,410,844,.486,85,192,.443,325,652,.498,.536,148,165,.897,49,193,242,400,101,14,141,189,1053
1987,Mark Alarie,PF,23,DEN,64,25,1110,217,443,.490,2,9,.222,215,434,.495,.492,67,101,.663,73,141,214,74,22,28,56,138,503
1987,Richard Anderson,PF,26,HOU,51,0,312,59,139,.424,4,16,.250,55,123,.447,.439,22,29,.759,24,55,79,33,7,3,19,37,144
1987,Ron Anderson,SF,28,IND,63,0,721,139,294,.473,0,5,.000,139,289,.481,.473,85,108,.787,73,78,151,54,31,3,55,65,363
1987,John Bagley,PG,26,CLE,72,67,2182,312,732,.426,31,103,.301,281,629,.447,.447,113,136,.831,55,197,252,379,91,7,163,114,768
1987,James Bailey,PF,29,NJN,34,2,542,112,239,.469,0,0,,112,239,.469,.469,58,80,.725,48,89,137,20,12,23,54,119,282
1987,Thurl Bailey,PF,25,UTA,81,2,2155,463,1036,.447,0,2,.000,463,1034,.448,.447,190,236,.805,145,287,432,102,38,88,123,150,1116
1987,Greg Ballard,SF,32,GSW,82,7,1579,248,564,.440,15,40,.375,233,524,.445,.453,68,91,.747,99,241,340,108,50,15,70,167,579
1987,Gene Banks,SF,27,CHI,63,39,1822,249,462,.539,0,5,.000,249,457,.545,.539,112,146,.767,115,193,308,170,52,17,113,173,610
1987,Charles Barkley*,PF,23,PHI,68,62,2740,557,937,.594,21,104,.202,536,833,.643,.606,429,564,.761,390,604,994,331,119,104,322,252,1564
1987,John Battle,SG,24,ATL,64,8,804,144,315,.457,0,10,.000,144,305,.472,.457,93,126,.738,16,44,60,124,29,5,60,76,381
1987,William Bedford,C,23,PHO,50,18,979,142,358,.397,0,1,.000,142,357,.398,.397,50,86,.581,79,167,246,57,18,37,85,125,334
1987,Benoit Benjamin,C,22,LAC,72,61,2230,320,713,.449,0,2,.000,320,711,.450,.449,188,263,.715,134,452,586,135,60,187,184,251,828
1987,Kent Benson,C,32,UTA,73,2,895,140,316,.443,2,7,.286,138,309,.447,.446,47,58,.810,80,151,231,39,39,28,45,138,329
1987,Walter Berry,SF-PF,22,TOT,63,45,1586,407,766,.531,0,3,.000,407,763,.533,.531,187,288,.649,136,173,309,105,38,40,153,196,1001
1987,Walter Berry,PF,22,POR,7,0,19,6,8,.750,0,0,,6,8,.750,.750,1,1,1.000,4,3,7,1,2,0,0,8,13
1987,Walter Berry,SF,22,SAS,56,45,1567,401,758,.529,0,3,.000,401,755,.531,.529,186,287,.648,132,170,302,104,36,40,153,188,988
1987,Joe Binion,PF,25,POR,11,0,51,4,10,.400,0,0,,4,10,.400,.400,6,10,.600,8,10,18,1,2,2,3,5,14
1987,Larry Bird*,SF,30,BOS,74,73,3005,786,1497,.525,90,225,.400,696,1272,.547,.555,414,455,.910,124,558,682,566,135,70,240,185,2076
1987,Otis Birdsong,SG,31,NJN,7,6,127,19,42,.452,0,1,.000,19,41,.463,.452,6,9,.667,3,4,7,17,3,0,9,16,44
1987,Uwe Blab,C,24,DAL,30,0,160,20,51,.392,0,0,,20,51,.392,.392,13,28,.464,11,25,36,13,4,9,15,33,53
1987,Rolando Blackman,SG,27,DAL,80,80,2758,626,1264,.495,5,15,.333,621,1249,.497,.497,419,474,.884,96,182,278,266,64,21,174,142,1676
1987,Manute Bol,C,24,WSB,82,12,1552,103,231,.446,0,1,.000,103,230,.448,.446,45,67,.672,84,278,362,11,20,302,61,189,251
1987,Sam Bowie,C,25,POR,5,5,163,30,66,.455,0,0,,30,66,.455,.455,20,30,.667,14,19,33,9,1,10,15,19,80
1987,Dudley Bradley,SG,29,MIL,68,2,900,76,213,.357,13,50,.260,63,163,.387,.387,47,58,.810,31,71,102,66,105,8,34,118,212
1987,Adrian Branch,SF,23,LAL,32,0,219,48,96,.500,0,2,.000,48,94,.511,.500,42,54,.778,23,30,53,16,16,3,24,39,138
1987,Randy Breuer,C,26,MIL,76,10,1467,241,497,.485,0,0,,241,497,.485,.485,118,202,.584,129,221,350,47,56,61,100,229,600
1987,Frank Brickowski,PF-C,27,TOT,44,0,487,63,124,.508,0,4,.000,63,120,.525,.508,50,70,.714,48,68,116,17,20,6,32,118,176
1987,Frank Brickowski,PF,27,LAL,37,0,404,53,94,.564,0,0,,53,94,.564,.564,40,59,.678,40,57,97,12,14,4,25,105,146
1987,Frank Brickowski,C,27,SAS,7,0,83,10,30,.333,0,4,.000,10,26,.385,.333,10,11,.909,8,11,19,5,6,2,7,13,30
1987,Junior Bridgeman,SF,33,MIL,34,4,418,79,171,.462,1,6,.167,78,165,.473,.465,16,20,.800,14,38,52,35,10,2,15,50,175
1987,Mike Brittain,C,23,SAS,6,0,29,4,9,.444,0,0,,4,9,.444,.444,1,2,.500,2,2,4,2,1,0,2,3,9
1987,Michael Brooks,SF,28,IND,10,0,148,13,37,.351,0,0,,13,37,.351,.351,7,10,.700,9,19,28,11,9,0,11,19,33
1987,Mike Brown,C,23,CHI,62,3,818,106,201,.527,0,0,,106,201,.527,.527,46,72,.639,71,143,214,24,20,7,59,129,258
1987,Tony Brown,SG,26,NJN,77,67,2339,358,810,.442,5,20,.250,353,790,.447,.445,152,206,.738,84,135,219,259,89,14,153,273,873
1987,Michael Cage,PF,25,LAC,80,76,2922,457,878,.521,0,3,.000,457,875,.522,.521,341,467,.730,354,568,922,131,99,67,171,221,1255
1987,Tony Campbell,SF,24,DET,40,0,332,57,145,.393,0,3,.000,57,142,.401,.393,24,39,.615,21,37,58,19,12,1,34,40,138
1987,Rick Carlisle,SG,27,BOS,42,0,297,30,92,.326,5,16,.313,25,76,.329,.353,15,20,.750,8,22,30,35,8,0,25,28,80
1987,Antoine Carr,PF,25,ATL,65,2,695,134,265,.506,1,3,.333,133,262,.508,.508,73,103,.709,60,96,156,34,14,48,40,146,342
1987,Kenny Carr,PF,31,POR,49,43,1443,201,399,.504,0,2,.000,201,397,.506,.504,126,169,.746,131,368,499,83,29,13,103,159,528
1987,Joe Barry Carroll,C,28,GSW,81,81,2724,690,1461,.472,0,0,,690,1461,.472,.472,340,432,.787,173,416,589,214,92,123,226,255,1720
1987,Bill Cartwright,C,29,NYK,58,50,1989,335,631,.531,0,0,,335,631,.531,.531,346,438,.790,132,313,445,96,40,26,128,188,1016
1987,Terry Catledge,PF,23,WSB,78,77,2149,413,835,.495,0,4,.000,413,831,.497,.495,199,335,.594,248,312,560,56,43,14,145,195,1025
1987,Tom Chambers,PF,27,SEA,82,82,3018,660,1446,.456,54,145,.372,606,1301,.466,.475,535,630,.849,163,382,545,245,81,50,268,307,1909
1987,Maurice Cheeks*,PG,30,PHI,68,68,2624,415,788,.527,4,17,.235,411,771,.533,.529,227,292,.777,47,168,215,538,180,15,173,109,1061
1987,Fred Cofield,PG,25,CHI,5,0,27,2,11,.182,0,1,.000,2,10,.200,.182,0,0,,1,4,5,4,2,0,1,1,4
1987,Ben Coleman,C,25,NJN,68,7,1029,182,313,.581,0,1,.000,182,312,.583,.581,88,121,.727,99,189,288,37,32,31,94,200,452
1987,Don Collins,SF,28,MIL,6,0,57,10,28,.357,0,0,,10,28,.357,.357,5,7,.714,11,4,15,2,2,1,5,11,25
1987,Steve Colter,PG,24,TOT,70,31,1322,169,397,.426,4,17,.235,165,380,.434,.431,82,107,.766,23,85,108,210,56,12,70,99,424
1987,Steve Colter,PG,24,CHI,27,18,473,49,142,.345,0,9,.000,49,133,.368,.345,33,39,.846,9,33,42,94,19,6,32,38,131
1987,Steve Colter,PG,24,PHI,43,13,849,120,255,.471,4,8,.500,116,247,.470,.478,49,68,.721,14,52,66,116,37,6,38,61,293
1987,Darwin Cook,SG,28,WSB,82,2,1420,265,622,.426,2,23,.087,263,599,.439,.428,82,103,.796,46,99,145,151,98,17,96,136,614
1987,Michael Cooper,SG,30,LAL,82,2,2253,322,736,.438,89,231,.385,233,505,.461,.498,126,148,.851,58,196,254,373,78,43,102,199,859
1987,Wayne Cooper,C,30,DEN,69,64,1561,235,524,.448,0,3,.000,235,521,.451,.448,79,109,.725,162,311,473,68,13,101,78,257,549
1987,Tyrone Corbin,SF,24,TOT,63,15,1170,156,381,.409,1,4,.250,155,377,.411,.411,91,124,.734,88,127,215,97,55,5,66,129,404
1987,Tyrone Corbin,SF,24,SAS,31,15,732,113,264,.428,0,0,,113,264,.428,.428,49,67,.731,52,67,119,80,38,3,46,81,275
1987,Tyrone Corbin,SF,24,CLE,32,0,438,43,117,.368,1,4,.250,42,113,.372,.372,42,57,.737,36,60,96,17,17,2,20,48,129
1987,Dave Corzine,C,30,CHI,82,39,2287,294,619,.475,0,5,.000,294,614,.479,.475,95,129,.736,199,341,540,209,38,87,114,202,683
1987,Pat Cummings,PF,30,NYK,49,11,1056,172,382,.450,0,0,,172,382,.450,.450,79,110,.718,123,189,312,38,26,7,85,145,423
1987,Terry Cummings,PF,25,MIL,82,77,2770,729,1426,.511,0,3,.000,729,1423,.512,.511,249,376,.662,214,486,700,229,129,81,172,296,1707
1987,Earl Cureton,C,29,TOT,78,47,1973,243,510,.476,0,2,.000,243,508,.478,.476,82,152,.539,212,240,452,122,33,56,80,188,568
1987,Earl Cureton,C,29,CHI,43,36,1105,129,276,.467,0,1,.000,129,275,.469,.467,39,73,.534,113,114,227,70,15,26,45,102,297
1987,Earl Cureton,C,29,LAC,35,11,868,114,234,.487,0,1,.000,114,233,.489,.487,43,79,.544,99,126,225,52,18,30,35,86,271
1987,Dell Curry,SG,22,UTA,67,0,636,139,326,.426,17,60,.283,122,266,.459,.452,30,38,.789,30,48,78,58,27,4,44,86,325
1987,Quintin Dailey,SG,26,LAC,49,5,924,200,491,.407,1,10,.100,199,481,.414,.408,119,155,.768,34,49,83,79,43,8,71,113,520
1987,Adrian Dantley*,SF,31,DET,81,81,2736,601,1126,.534,1,6,.167,600,1120,.536,.534,539,664,.812,104,228,332,162,63,7,181,193,1742
1987,Brad Daugherty,C,21,CLE,80,80,2695,487,905,.538,0,0,,487,905,.538,.538,279,401,.696,152,495,647,304,49,63,248,248,1253
1987,Brad Davis,PG,31,DAL,82,6,1582,199,436,.456,32,106,.302,167,330,.506,.493,147,171,.860,27,87,114,373,63,10,114,159,577
1987,Walter Davis,SG,32,PHO,79,79,2646,779,1515,.514,21,81,.259,758,1434,.529,.521,288,334,.862,90,154,244,364,96,5,226,184,1867
1987,Darryl Dawkins,C,30,NJN,6,2,106,20,32,.625,0,0,,20,32,.625,.625,17,24,.708,9,10,19,2,2,3,15,25,57
1987,Johnny Dawkins,PG,23,SAS,81,14,1682,334,764,.437,14,47,.298,320,717,.446,.446,153,191,.801,56,113,169,290,67,3,120,118,835
1987,Darren Daye,SF,26,TOT,62,2,731,101,202,.500,0,0,,101,202,.500,.500,34,65,.523,37,88,125,76,25,7,57,100,236
1987,Darren Daye,SF,26,CHI,1,0,7,0,0,,0,0,,0,0,,,0,0,,0,1,1,1,0,0,1,2,0
1987,Darren Daye,SF,26,BOS,61,2,724,101,202,.500,0,0,,101,202,.500,.500,34,65,.523,37,87,124,75,25,7,56,98,236
1987,James Donaldson,C,29,DAL,82,82,3028,311,531,.586,0,0,,311,531,.586,.586,267,329,.812,295,678,973,63,51,136,104,191,889
1987,Bruce Douglas,SG,22,SAC,8,1,98,7,24,.292,0,1,.000,7,23,.304,.292,0,4,.000,5,9,14,17,9,0,9,9,14
1987,Greg Dreiling,C,24,IND,24,0,128,16,37,.432,0,0,,16,37,.432,.432,10,12,.833,12,31,43,7,2,2,7,42,42
1987,Larry Drew,PG,28,LAC,60,22,1566,295,683,.432,12,72,.167,283,611,.463,.441,139,166,.837,26,77,103,326,60,2,151,107,741
1987,Clyde Drexler*,SG,24,POR,82,82,3114,707,1408,.502,11,47,.234,696,1361,.511,.506,357,470,.760,227,291,518,566,204,71,253,281,1782
1987,Kevin Duckworth,C,22,TOT,65,1,875,130,273,.476,0,1,.000,130,272,.478,.476,92,134,.687,76,147,223,29,21,21,78,192,352
1987,Kevin Duckworth,C,22,SAS,14,1,122,18,45,.400,0,0,,18,45,.400,.400,9,14,.643,13,18,31,6,5,3,4,27,45
1987,Kevin Duckworth,C,22,POR,51,0,753,112,228,.491,0,1,.000,112,227,.493,.491,83,120,.692,63,129,192,23,16,18,74,165,307
1987,Joe Dumars*,SG,23,DET,79,75,2439,369,749,.493,9,22,.409,360,727,.495,.499,184,246,.748,50,117,167,352,83,5,171,194,931
1987,T.R. Dunn,SG,31,DEN,81,53,1932,118,276,.428,0,2,.000,118,274,.431,.428,36,55,.655,91,174,265,147,100,21,33,160,272
1987,Mark Eaton,C,30,UTA,79,79,2505,234,585,.400,0,0,,234,585,.400,.400,140,213,.657,211,486,697,105,43,321,142,273,608
1987,Jerry Eaves,PG,27,SAC,3,0,26,1,8,.125,0,0,,1,8,.125,.125,2,2,1.000,1,0,1,0,1,0,2,6,4
1987,Franklin Edwards,PG,27,SAC,8,0,122,9,32,.281,0,4,.000,9,28,.321,.281,10,14,.714,2,8,10,29,5,0,17,7,28
1987,James Edwards,C,31,PHO,14,9,304,57,110,.518,0,0,,57,110,.518,.518,54,70,.771,20,40,60,19,6,7,15,42,168
1987,Craig Ehlo,SG,25,CLE,44,15,890,99,239,.414,5,29,.172,94,210,.448,.425,70,99,.707,55,106,161,92,40,30,61,80,273
1987,Dale Ellis,SG,26,SEA,82,76,3073,785,1520,.516,86,240,.358,699,1280,.546,.545,385,489,.787,187,260,447,238,104,32,238,267,2041
1987,Chris Engler,C,27,TOT,30,0,195,23,51,.451,0,0,,23,51,.451,.451,12,16,.750,23,34,57,8,5,11,12,33,58
1987,Chris Engler,C,27,POR,7,0,17,4,8,.500,0,0,,4,8,.500,.500,3,3,1.000,6,2,8,1,1,1,2,0,11
1987,Chris Engler,C,27,MIL,5,0,48,3,12,.250,0,0,,3,12,.250,.250,1,1,1.000,3,13,16,3,1,1,0,10,7
1987,Chris Engler,C,27,NJN,18,0,130,16,31,.516,0,0,,16,31,.516,.516,8,12,.667,14,19,33,4,3,9,10,23,40
1987,Alex English*,SF,33,DEN,82,82,3085,965,1920,.503,4,15,.267,961,1905,.504,.504,411,487,.844,146,198,344,422,73,21,214,216,2345
1987,Julius Erving*,SF,36,PHI,60,60,1918,400,850,.471,14,53,.264,386,797,.484,.479,191,235,.813,115,149,264,191,76,94,158,137,1005
1987,Mike Evans,SG,31,DEN,81,4,1567,334,729,.458,53,169,.314,281,560,.502,.495,96,123,.780,36,92,128,185,79,12,107,149,817
1987,Patrick Ewing*,PF,24,NYK,63,63,2206,530,1053,.503,0,7,.000,530,1046,.507,.503,296,415,.713,157,398,555,104,89,147,229,248,1356
1987,Dave Feitl,C,24,HOU,62,1,498,88,202,.436,0,1,.000,88,201,.438,.436,53,71,.746,39,78,117,22,9,4,38,83,229
1987,Kenny Fields,SF,24,TOT,48,17,883,159,352,.452,3,12,.250,156,340,.459,.456,73,94,.777,63,85,148,61,32,11,53,123,394
1987,Kenny Fields,SF,24,MIL,4,0,22,6,8,.750,0,0,,6,8,.750,.750,1,5,.200,0,2,2,1,1,0,1,3,13
1987,Kenny Fields,SF,24,LAC,44,17,861,153,344,.445,3,12,.250,150,332,.452,.449,72,89,.809,63,83,146,60,31,11,52,120,381
1987,Vern Fleming,PG,24,IND,82,82,2549,370,727,.509,2,10,.200,368,717,.513,.510,238,302,.788,109,225,334,473,109,18,167,222,980
1987,Sleepy Floyd,PG,26,GSW,82,82,3064,503,1030,.488,73,190,.384,430,840,.512,.524,462,537,.860,56,212,268,848,146,18,280,199,1541
1987,World B. Free,SG,33,PHI,20,2,285,39,123,.317,2,9,.222,37,114,.325,.325,36,47,.766,5,14,19,30,5,4,18,26,116
1987,Kenny Gattison,PF,22,PHO,77,14,1104,148,311,.476,0,3,.000,148,308,.481,.476,108,171,.632,87,183,270,36,24,33,88,178,404
1987,Artis Gilmore*,C,37,SAS,82,74,2405,346,580,.597,0,0,,346,580,.597,.597,242,356,.680,185,394,579,150,39,95,178,235,934
1987,Mike Glenn,SG,31,MIL,4,0,34,5,13,.385,0,0,,5,13,.385,.385,5,7,.714,0,2,2,1,1,0,0,3,15
1987,Mike Gminski,C,27,NJN,72,66,2272,433,947,.457,0,0,,433,947,.457,.457,313,370,.846,192,438,630,99,52,69,129,159,1179
1987,Grant Gondrezick,SG,24,PHO,64,1,836,135,300,.450,4,17,.235,131,283,.463,.457,75,107,.701,47,63,110,81,25,4,56,91,349
1987,Lancaster Gordon,SG,24,LAC,70,4,1130,221,545,.406,14,48,.292,207,497,.416,.418,70,95,.737,64,62,126,139,61,13,102,106,526
1987,Stewart Granger,PG,25,NYK,15,0,166,20,54,.370,0,3,.000,20,51,.392,.370,9,11,.818,6,11,17,27,7,1,22,17,49
1987,Stuart Gray,C,23,IND,55,1,456,41,101,.406,0,0,,41,101,.406,.406,28,39,.718,39,90,129,26,10,28,36,93,110
1987,A.C. Green,PF,23,LAL,79,72,2240,316,587,.538,0,5,.000,316,582,.543,.538,220,282,.780,210,405,615,84,70,80,102,171,852
1987,Kenny Green,SF,22,PHI,19,0,172,25,70,.357,0,0,,25,70,.357,.357,14,19,.737,6,22,28,7,4,2,15,8,64
1987,Rickey Green,PG,32,UTA,81,80,2090,301,644,.467,7,19,.368,294,625,.470,.473,172,208,.827,38,125,163,541,110,2,133,108,781
1987,Sidney Green,PF,26,DET,80,69,1792,256,542,.472,0,2,.000,256,540,.474,.472,119,177,.672,196,457,653,62,41,50,127,197,631
1987,Dave Greenwood,PF,29,SAS,79,78,2587,336,655,.513,3,6,.500,333,649,.513,.515,241,307,.785,256,527,783,237,71,50,161,248,916
1987,Darrell Griffith,SG,28,UTA,76,10,1843,463,1038,.446,67,200,.335,396,838,.473,.478,149,212,.703,81,146,227,129,97,29,135,167,1142
1987,Bob Hansen,SG,26,UTA,72,72,1453,272,601,.453,16,45,.356,256,556,.460,.466,136,179,.760,84,119,203,102,44,6,77,146,696
1987,Bill Hanzlik,PF,29,DEN,73,10,1990,307,746,.412,22,80,.275,285,666,.428,.426,316,402,.786,79,177,256,280,87,28,132,245,952
1987,Derek Harper,PG,25,DAL,77,76,2556,497,993,.501,76,212,.358,421,781,.539,.539,160,234,.684,51,148,199,609,167,25,138,195,1230
1987,Ron Harper,SG,23,CLE,82,82,3064,734,1614,.455,20,94,.213,714,1520,.470,.461,386,564,.684,169,223,392,394,209,84,345,247,1874
1987,Steve Harris,SG,23,HOU,74,3,1174,251,599,.419,0,8,.000,251,591,.425,.419,111,130,.854,71,99,170,100,37,16,74,111,613
1987,Scott Hastings,PF,26,ATL,40,0,256,23,68,.338,2,12,.167,21,56,.375,.353,23,29,.793,16,54,70,13,10,7,13,35,71
1987,Cedric Henderson,PF,21,TOT,8,0,16,4,8,.500,0,0,,4,8,.500,.500,3,3,1.000,3,5,8,0,0,0,4,2,11
1987,Cedric Henderson,PF,21,ATL,6,0,10,2,5,.400,0,0,,2,5,.400,.400,1,1,1.000,2,1,3,0,0,0,1,1,5
1987,Cedric Henderson,PF,21,MIL,2,0,6,2,3,.667,0,0,,2,3,.667,.667,2,2,1.000,1,4,5,0,0,0,3,1,6
1987,Gerald Henderson,PG,31,TOT,74,59,2045,298,674,.442,19,77,.247,279,597,.467,.456,190,230,.826,50,125,175,471,101,11,172,208,805
1987,Gerald Henderson,PG,31,SEA,6,6,155,25,50,.500,0,3,.000,25,47,.532,.500,17,18,.944,6,3,9,32,6,0,15,17,67
1987,Gerald Henderson,PG,31,NYK,68,53,1890,273,624,.438,19,74,.257,254,550,.462,.453,173,212,.816,44,122,166,439,95,11,157,191,738
1987,Jerome Henderson,PF,27,MIL,6,0,36,4,13,.308,0,0,,4,13,.308,.308,4,4,1.000,2,5,7,0,1,1,6,12,12
1987,Kevin Henderson,PG,22,GSW,5,0,45,3,8,.375,0,0,,3,8,.375,.375,2,2,1.000,1,2,3,11,1,0,4,9,8
1987,Conner Henry,SG,23,TOT,54,0,323,46,136,.338,13,42,.310,33,94,.351,.386,17,27,.630,7,27,34,35,9,1,26,34,122
1987,Conner Henry,SG,23,HOU,18,0,92,8,33,.242,1,11,.091,7,22,.318,.258,7,10,.700,0,7,7,8,3,0,9,7,24
1987,Conner Henry,SG,23,BOS,36,0,231,38,103,.369,12,31,.387,26,72,.361,.427,10,17,.588,7,20,27,27,6,1,17,27,98
1987,Rod Higgins,SF,27,GSW,73,28,1497,214,412,.519,3,17,.176,211,395,.534,.523,200,240,.833,72,165,237,96,40,21,76,145,631
1987,Roy Hinson,SF,25,PHI,76,58,2489,393,823,.478,0,1,.000,393,822,.478,.478,273,360,.758,150,338,488,60,45,161,149,281,1059
1987,Craig Hodges,PG,26,MIL,78,43,2147,315,682,.462,85,228,.373,230,454,.507,.524,131,147,.891,48,92,140,240,76,7,124,189,846
1987,Michael Holton,PG,25,POR,58,1,479,70,171,.409,7,23,.304,63,148,.426,.430,44,55,.800,9,29,38,73,16,2,41,51,191
1987,Jeff Hornacek,SG,23,PHO,80,3,1561,159,350,.454,12,43,.279,147,307,.479,.471,94,121,.777,41,143,184,361,70,5,153,130,424
1987,Phil Hubbard,SF,30,CLE,68,68,2083,321,605,.531,0,4,.000,321,601,.534,.531,162,272,.596,178,210,388,136,66,7,156,224,804
1987,Jay Humphries,PG,24,PHO,82,82,2579,359,753,.477,5,27,.185,354,726,.488,.480,200,260,.769,62,198,260,632,112,9,195,239,923
1987,Geoff Huston,PG,29,LAC,19,8,428,55,121,.455,1,2,.500,54,119,.454,.459,18,34,.529,6,11,17,101,14,0,45,28,129
1987,Marc Iavaroni,PF,30,UTA,78,0,845,100,215,.465,0,4,.000,100,211,.474,.465,78,116,.672,64,109,173,36,16,11,56,154,278
1987,Myron Jackson,PG,22,DAL,8,0,22,2,9,.222,0,0,,2,9,.222,.222,7,8,.875,1,2,3,6,1,0,5,1,11
1987,Buck Johnson,SF,23,HOU,60,3,520,94,201,.468,0,1,.000,94,200,.470,.468,40,58,.690,38,50,88,40,17,15,37,81,228
1987,Clemon Johnson,C,30,SEA,78,7,1051,88,178,.494,0,2,.000,88,176,.500,.494,70,110,.636,106,171,277,21,21,42,36,137,246
1987,Dennis Johnson*,PG,32,BOS,79,78,2933,423,953,.444,7,62,.113,416,891,.467,.448,209,251,.833,45,216,261,594,87,38,177,201,1062
1987,Eddie Johnson,SG,31,SEA,24,0,508,85,186,.457,5,15,.333,80,171,.468,.470,42,55,.764,11,35,46,115,12,1,41,36,217
1987,Eddie Johnson,SF,27,SAC,81,30,2457,606,1309,.463,37,118,.314,569,1191,.478,.477,267,322,.829,146,207,353,251,42,19,163,218,1516
1987,Frank Johnson,PG,28,WSB,18,10,399,59,128,.461,0,1,.000,59,127,.465,.461,35,49,.714,10,20,30,58,21,0,31,31,153
1987,Magic Johnson*,PG,27,LAL,80,80,2904,683,1308,.522,8,39,.205,675,1269,.532,.525,535,631,.848,122,382,504,977,138,36,300,168,1909
1987,Marques Johnson,SF,30,LAC,10,10,302,68,155,.439,0,6,.000,68,149,.456,.439,30,42,.714,9,24,33,28,12,5,17,24,166
1987,Steffond Johnson,PF,24,LAC,29,0,234,27,64,.422,0,3,.000,27,61,.443,.422,20,38,.526,15,28,43,5,9,2,18,55,74
1987,Steve Johnson,C,29,POR,79,74,2345,494,889,.556,0,0,,494,889,.556,.556,342,490,.698,194,372,566,155,49,76,276,340,1330
1987,Vinnie Johnson,SG,30,DET,78,8,2166,533,1154,.462,4,14,.286,529,1140,.464,.464,158,201,.786,123,134,257,300,92,16,133,159,1228
1987,Anthony Jones,SF-SG,24,TOT,65,4,858,133,322,.413,7,20,.350,126,302,.417,.424,50,65,.769,40,64,104,73,42,19,49,79,323
1987,Anthony Jones,SG,24,WSB,16,1,114,14,33,.424,0,1,.000,14,32,.438,.424,9,13,.692,1,8,9,7,10,1,11,11,37
1987,Anthony Jones,SF,24,SAS,49,3,744,119,289,.412,7,19,.368,112,270,.415,.424,41,52,.788,39,56,95,66,32,18,38,68,286
1987,Caldwell Jones,PF,36,POR,78,37,1578,111,224,.496,0,2,.000,111,222,.500,.496,97,124,.782,114,341,455,64,23,77,87,227,319
1987,Charles Jones,PF,29,WSB,79,64,1609,118,249,.474,0,1,.000,118,248,.476,.474,48,76,.632,144,212,356,80,67,165,77,252,284
1987,Michael Jordan*,SG,23,CHI,82,82,3281,1098,2279,.482,12,66,.182,1086,2213,.491,.484,833,972,.857,166,264,430,377,236,125,272,237,3041
1987,Clark Kellogg,PF,25,IND,4,4,60,8,22,.364,1,2,.500,7,20,.350,.386,3,4,.750,7,4,11,6,5,0,4,12,20
1987,Tim Kempton,PF,23,LAC,66,6,936,97,206,.471,0,1,.000,97,205,.473,.471,95,137,.693,70,124,194,53,38,12,49,162,289
1987,Jerome Kersey,SF,24,POR,82,8,2088,373,733,.509,1,23,.043,372,710,.524,.510,262,364,.720,201,295,496,194,122,77,149,328,1009
1987,Albert King,SF,27,NJN,61,15,1291,244,573,.426,13,32,.406,231,541,.427,.437,81,100,.810,82,132,214,103,34,28,103,177,582
1987,Bernard King*,SF,30,NYK,6,4,214,52,105,.495,0,0,,52,105,.495,.495,32,43,.744,13,19,32,19,2,0,15,14,136
1987,Curtis Kitchen,PF,23,SEA,6,0,31,3,6,.500,0,1,.000,3,5,.600,.500,3,4,.750,4,5,9,1,2,3,0,4,9
1987,Greg Kite,C,25,BOS,74,1,745,47,110,.427,0,1,.000,47,109,.431,.427,29,76,.382,61,108,169,27,17,46,34,148,123
1987,Joe Kleine,C,25,SAC,79,31,1658,256,543,.471,0,1,.000,256,542,.472,.471,110,140,.786,173,310,483,71,35,30,90,213,622
1987,Jon Koncak,C,23,ATL,82,19,1684,169,352,.480,0,1,.000,169,351,.481,.480,125,191,.654,153,340,493,31,52,76,92,262,463
1987,Larry Krystkowiak,PF,22,SAS,68,2,1004,170,373,.456,1,12,.083,169,361,.468,.457,110,148,.743,77,162,239,85,22,12,67,141,451
1987,Bill Laimbeer,C,29,DET,82,82,2854,506,1010,.501,6,21,.286,500,989,.506,.504,245,274,.894,243,712,955,151,72,69,120,283,1263
1987,Jim Lampley,C,26,PHI,1,0,16,1,3,.333,0,0,,1,3,.333,.333,1,2,.500,1,4,5,0,1,0,1,0,3
1987,Allen Leavell,PG,29,HOU,53,11,1175,147,358,.411,18,57,.316,129,301,.429,.436,100,119,.840,14,47,61,224,53,10,64,126,412
1987,Keith Lee,PF,24,CLE,67,1,870,170,374,.455,0,1,.000,170,373,.456,.455,72,101,.713,93,158,251,69,25,40,85,147,412
1987,Fat Lever,PG,26,DEN,82,82,3054,643,1370,.469,22,92,.239,621,1278,.486,.477,244,312,.782,216,513,729,654,201,34,167,219,1552
1987,Cliff Levingston,PF,26,ATL,82,10,1848,251,496,.506,0,3,.000,251,493,.509,.506,155,212,.731,219,314,533,40,48,68,72,261,657
1987,Alton Lister,C,28,SEA,75,75,2288,346,687,.504,0,1,.000,346,686,.504,.504,179,265,.675,223,482,705,110,32,180,169,289,871
1987,Lewis Lloyd,SG,27,HOU,32,14,688,165,310,.532,1,7,.143,164,303,.541,.534,65,86,.756,13,35,48,90,19,5,52,69,396
1987,John Long,SG,30,IND,80,68,2265,490,1170,.419,19,67,.284,471,1103,.427,.427,219,246,.890,75,142,217,258,96,8,153,167,1218
1987,John Lucas,PG,33,MIL,43,40,1358,285,624,.457,46,126,.365,239,498,.480,.494,137,174,.787,29,96,125,290,71,6,89,82,753
1987,Maurice Lucas,PF,34,SEA,63,0,1120,175,388,.451,0,5,.000,175,383,.457,.451,150,187,.802,88,219,307,65,34,21,75,171,500
1987,Kyle Macy,PG,29,IND,76,0,1250,164,341,.481,14,46,.304,150,295,.508,.501,34,41,.829,25,88,113,197,59,7,58,136,376
1987,Rick Mahorn,PF,28,DET,63,6,1278,144,322,.447,0,0,,144,322,.447,.447,96,117,.821,93,282,375,38,32,50,73,221,384
1987,Jeff Malone,SG,25,WSB,80,79,2763,689,1509,.457,4,26,.154,685,1483,.462,.458,376,425,.885,50,168,218,298,75,13,182,154,1758
1987,Karl Malone*,PF,23,UTA,82,82,2857,728,1422,.512,0,7,.000,728,1415,.514,.512,323,540,.598,278,577,855,158,104,60,237,323,1779
1987,Moses Malone*,C,31,WSB,73,70,2488,595,1311,.454,0,11,.000,595,1300,.458,.454,570,692,.824,340,484,824,120,59,92,202,139,1760
1987,Pace Mannion,SF,26,NJN,23,3,284,31,94,.330,3,9,.333,28,85,.329,.346,18,31,.581,10,29,39,45,18,4,23,32,83
1987,Bill Martin,SF,24,NYK,8,0,68,9,25,.360,0,0,,9,25,.360,.360,7,8,.875,2,5,7,0,4,2,7,5,25
1987,Fernando Martín,C,24,POR,24,0,146,9,31,.290,0,1,.000,9,30,.300,.290,4,11,.364,8,20,28,9,7,1,20,24,22
1987,Maurice Martin,SF,22,DEN,43,0,286,51,135,.378,3,15,.200,48,120,.400,.389,42,66,.636,12,29,41,35,13,6,33,48,147
1987,Wes Matthews,PG,27,LAL,50,0,532,89,187,.476,1,3,.333,88,184,.478,.479,29,36,.806,13,34,47,100,23,4,51,53,208
1987,Cedric Maxwell,SF,31,TOT,81,31,1968,253,477,.530,0,1,.000,253,476,.532,.530,303,391,.775,175,260,435,197,39,14,136,178,809
1987,Cedric Maxwell,SF,31,LAC,35,31,1132,150,289,.519,0,0,,150,289,.519,.519,177,228,.776,103,148,251,122,26,9,88,102,477
1987,Cedric Maxwell,SF,31,HOU,46,0,836,103,188,.548,0,1,.000,103,187,.551,.548,126,163,.773,72,112,184,75,13,5,48,76,332
1987,Tim McCormick,C,24,PHI,81,79,2817,391,718,.545,0,4,.000,391,714,.548,.545,251,349,.719,180,431,611,114,36,64,153,270,1033
1987,Rodney McCray,SF,25,HOU,81,81,3136,432,783,.552,0,9,.000,432,774,.558,.552,306,393,.779,190,388,578,434,88,53,208,172,1170
1987,Scooter McCray,PF,26,CLE,24,2,279,30,65,.462,0,0,,30,65,.462,.462,20,41,.488,19,39,58,23,9,4,24,28,80
1987,Xavier McDaniel,SF,23,SEA,82,82,3031,806,1583,.509,3,14,.214,803,1569,.512,.510,275,395,.696,338,367,705,207,115,52,234,300,1890
1987,Ben McDonald,PF,24,GSW,63,34,1284,164,360,.456,1,8,.125,163,352,.463,.457,24,38,.632,63,120,183,84,27,8,43,200,353
1987,Hank McDowell,PF,27,MIL,7,0,70,8,17,.471,0,0,,8,17,.471,.471,6,7,.857,9,10,19,2,2,0,3,14,22
1987,Mike McGee,SF,27,ATL,76,6,1420,311,677,.459,86,229,.376,225,448,.502,.523,80,137,.584,71,88,159,149,61,2,104,156,788
1987,Kevin McHale*,PF,29,BOS,77,77,3060,790,1307,.604,0,4,.000,790,1303,.606,.604,428,512,.836,247,516,763,198,38,172,197,240,2008
1987,Kevin McKenna,SG,28,NJN,56,3,942,153,337,.454,52,124,.419,101,213,.474,.531,43,57,.754,21,56,77,93,54,7,53,141,401
1987,Forrest McKenzie,SF,23,SAS,6,0,42,7,28,.250,1,2,.500,6,26,.231,.268,2,2,1.000,2,5,7,1,1,0,3,9,17
1987,Nate McMillan,PG,22,SEA,71,50,1972,143,301,.475,0,7,.000,143,294,.486,.475,87,141,.617,101,230,331,583,125,45,155,238,373
1987,Mark McNamara,C,27,PHI,11,1,113,14,30,.467,0,0,,14,30,.467,.467,7,19,.368,17,19,36,2,1,0,8,17,35
1987,Chris McNealy,PF,25,NYK,59,16,972,88,179,.492,0,0,,88,179,.492,.492,52,80,.650,74,153,227,46,36,16,64,136,228
1987,Cozell McQueen,PF,25,DET,3,0,7,3,3,1.000,0,0,,3,3,1.000,1.000,0,0,,3,5,8,0,0,1,0,1,6
1987,Dirk Minniefield,PG,26,TOT,74,52,1600,218,482,.452,11,39,.282,207,443,.467,.464,62,90,.689,29,111,140,348,72,7,157,174,509
1987,Dirk Minniefield,PG,26,CLE,11,0,122,13,42,.310,0,5,.000,13,37,.351,.310,1,4,.250,1,9,10,13,6,1,12,8,27
1987,Dirk Minniefield,PG,26,HOU,63,52,1478,205,440,.466,11,34,.324,194,406,.478,.478,61,86,.709,28,102,130,335,66,6,145,166,482
1987,Mike Mitchell,SF,31,SAS,40,18,922,208,478,.435,1,2,.500,207,476,.435,.436,92,112,.821,38,65,103,38,19,9,51,68,509
1987,Paul Mokeski,C,30,MIL,62,3,626,52,129,.403,0,1,.000,52,128,.406,.403,46,64,.719,45,93,138,22,18,13,22,126,150
1987,Sidney Moncrief*,SG,29,MIL,39,30,992,158,324,.488,8,31,.258,150,293,.512,.500,136,162,.840,57,70,127,121,27,10,63,73,460
1987,Johnny Moore,PG,28,SAS,55,27,1234,198,448,.442,22,79,.278,176,369,.477,.467,56,70,.800,32,68,100,250,83,3,102,97,474
1987,Perry Moss,PG,28,GSW,64,0,698,91,207,.440,1,14,.071,90,193,.466,.442,49,69,.710,29,66,95,90,42,3,57,96,232
1987,Chris Mullin*,SG,23,GSW,82,82,2377,477,928,.514,19,63,.302,458,865,.529,.524,269,326,.825,39,142,181,261,98,36,154,217,1242
1987,Jay Murphy,PF,24,WSB,21,0,141,31,72,.431,0,0,,31,72,.431,.431,9,16,.563,17,22,39,5,3,2,6,21,71
1987,Pete Myers,SG,23,CHI,29,0,155,19,52,.365,0,6,.000,19,46,.413,.365,28,43,.651,8,9,17,21,14,2,10,25,66
1987,Larry Nance,PF,27,PHO,69,67,2569,585,1062,.551,1,5,.200,584,1057,.553,.551,381,493,.773,188,411,599,233,86,148,149,223,1552
1987,Calvin Natt,PF,30,DEN,1,1,20,4,10,.400,0,0,,4,10,.400,.400,2,2,1.000,2,3,5,2,1,0,1,2,10
1987,Ed Nealy,PF,26,SAS,60,7,980,84,192,.438,4,31,.129,80,161,.497,.448,51,69,.739,96,188,284,83,40,11,36,144,223
1987,Chuck Nevitt,C,27,DET,41,0,267,31,63,.492,0,0,,31,63,.492,.492,14,24,.583,36,47,83,4,7,30,21,73,76
1987,Johnny Newman,SF,23,CLE,59,0,630,113,275,.411,1,22,.045,112,253,.443,.413,66,76,.868,36,34,70,27,20,7,46,67,293
1987,Kurt Nimphius,PF,28,TOT,66,11,1088,155,330,.470,0,4,.000,155,326,.475,.470,81,120,.675,80,107,187,25,20,54,63,156,391
1987,Kurt Nimphius,PF,28,LAC,38,6,811,119,252,.472,0,3,.000,119,249,.478,.472,57,88,.648,58,75,133,18,16,41,47,118,295
1987,Kurt Nimphius,PF,28,DET,28,5,277,36,78,.462,0,1,.000,36,77,.468,.462,24,32,.750,22,32,54,7,4,13,16,38,96
1987,Dennis Nutt,PG,23,DAL,25,0,91,16,40,.400,5,17,.294,11,23,.478,.463,20,22,.909,1,7,8,16,7,0,10,6,57
1987,Mike O'Koren,SF,28,WSB,15,0,123,16,42,.381,0,2,.000,16,40,.400,.381,0,2,.000,6,8,14,13,2,0,6,10,32
1987,Charles Oakley,PF,23,CHI,82,81,2980,468,1052,.445,11,30,.367,457,1022,.447,.450,245,357,.686,299,775,1074,296,85,36,299,315,1192
1987,Hakeem Olajuwon*,C,24,HOU,75,75,2760,677,1332,.508,1,5,.200,676,1327,.509,.509,400,570,.702,315,543,858,220,140,254,228,294,1755
1987,Mark Olberding,PF,30,SAC,76,0,1002,69,165,.418,0,1,.000,69,164,.421,.418,116,131,.885,50,135,185,91,18,9,56,144,254
1987,Jawann Oldham,C,29,NYK,44,9,776,71,174,.408,0,1,.000,71,173,.410,.408,31,57,.544,51,128,179,19,22,71,48,95,173
1987,Louis Orr,SF,28,NYK,65,8,1440,166,389,.427,1,5,.200,165,384,.430,.428,125,172,.727,102,130,232,110,47,18,70,123,458
1987,Robert Parish*,C,33,BOS,80,80,2995,588,1057,.556,0,1,.000,588,1056,.557,.556,227,309,.735,254,597,851,173,64,144,191,266,1403
1987,Jim Paxson,SG,29,POR,72,1,1798,337,733,.460,26,98,.265,311,635,.490,.477,174,216,.806,41,98,139,237,76,12,108,134,874
1987,John Paxson,PG,26,CHI,82,64,2689,386,793,.487,52,140,.371,334,653,.511,.520,106,131,.809,22,117,139,467,66,8,105,207,930
1987,Sam Perkins,PF,25,DAL,80,80,2687,461,957,.482,19,54,.352,442,903,.489,.492,245,296,.828,197,419,616,146,109,77,132,269,1186
1987,Chuck Person,SF,22,IND,82,78,2956,635,1358,.468,49,138,.355,586,1220,.480,.486,222,297,.747,168,509,677,295,90,16,211,310,1541
1987,Jim Petersen,PF,24,HOU,82,56,2403,386,755,.511,0,4,.000,386,751,.514,.511,152,209,.727,177,380,557,127,43,102,152,268,924
1987,Michael Phelps,SG,25,SEA,60,6,469,75,176,.426,1,10,.100,74,166,.446,.429,31,44,.705,16,34,50,64,21,2,32,60,182
1987,Ricky Pierce,SG,27,MIL,79,31,2505,575,1077,.534,3,28,.107,572,1049,.545,.535,387,440,.880,117,149,266,144,64,24,120,222,1540
1987,Ed Pinckney,SF,23,PHO,80,65,2250,290,497,.584,0,2,.000,290,495,.586,.584,257,348,.739,179,401,580,116,86,54,135,196,837
1987,Dwayne Polee,SG,23,LAC,1,0,6,1,4,.250,0,3,.000,1,1,1.000,.250,0,0,,0,0,0,0,1,0,1,3,2
1987,Ben Poquette,PF,31,TOT,58,2,604,62,122,.508,0,4,.000,62,118,.525,.508,40,50,.800,30,71,101,35,9,34,21,77,164
1987,Ben Poquette,PF,31,CLE,37,1,437,41,82,.500,0,3,.000,41,79,.519,.500,31,39,.795,20,57,77,28,6,22,17,51,113
1987,Ben Poquette,PF,31,CHI,21,1,167,21,40,.525,0,1,.000,21,39,.538,.525,9,11,.818,10,14,24,7,3,12,4,26,51
1987,Terry Porter,PG,23,POR,80,80,2714,376,770,.488,13,60,.217,363,710,.511,.497,280,334,.838,70,267,337,715,159,9,255,192,1045
1987,Paul Pressey,SF,28,MIL,61,60,2057,294,616,.477,16,55,.291,278,561,.496,.490,242,328,.738,98,198,296,441,110,47,186,213,846
1987,Harold Pressley,SF,23,SAC,67,23,913,134,317,.423,7,28,.250,127,289,.439,.434,35,48,.729,68,108,176,120,40,21,63,96,310
1987,Mark Price,PG,22,CLE,67,0,1217,173,424,.408,23,70,.329,150,354,.424,.435,95,114,.833,33,84,117,202,43,4,105,75,464
1987,Kurt Rambis,PF,28,LAL,78,10,1514,163,313,.521,0,0,,163,313,.521,.521,120,157,.764,159,294,453,63,74,41,104,201,446
1987,Blair Rasmussen,C,24,DEN,74,23,1421,268,570,.470,0,0,,268,570,.470,.470,169,231,.732,183,282,465,60,24,58,79,224,705
1987,Robert Reid,SG,31,HOU,75,63,2594,420,1006,.417,53,162,.327,367,844,.435,.444,136,177,.768,47,242,289,323,75,21,104,232,1029
1987,Jerry Reynolds,SF,24,MIL,58,24,963,140,356,.393,6,18,.333,134,338,.396,.402,118,184,.641,72,101,173,106,50,30,82,91,404
1987,Clint Richardson,SG,30,IND,78,14,1396,218,467,.467,6,17,.353,212,450,.471,.473,59,74,.797,51,92,143,241,49,7,85,106,501
1987,Doc Rivers,PG,25,ATL,82,82,2590,342,758,.451,4,21,.190,338,737,.459,.454,365,441,.828,83,216,299,823,171,30,217,287,1053
1987,Fred Roberts,PF,26,BOS,73,11,1079,139,270,.515,0,3,.000,139,267,.521,.515,124,153,.810,54,136,190,62,22,20,89,129,402
1987,Alvin Robertson,SG,24,SAS,81,78,2697,589,1264,.466,13,48,.271,576,1216,.474,.471,244,324,.753,186,238,424,421,260,35,243,264,1435
1987,Cliff Robinson,PF,26,PHI,55,30,1586,338,729,.464,0,4,.000,338,725,.466,.464,139,184,.755,86,221,307,89,86,30,123,150,815
1987,Dennis Rodman*,SF,25,DET,77,1,1155,213,391,.545,0,1,.000,213,390,.546,.545,74,126,.587,163,169,332,56,38,48,93,166,500
1987,Johnny Rogers,PF,23,SAC,45,15,468,90,185,.486,0,5,.000,90,180,.500,.486,9,15,.600,30,47,77,26,9,8,20,66,189
1987,Tree Rollins,C,31,ATL,75,58,1764,171,313,.546,0,0,,171,313,.546,.546,63,87,.724,155,333,488,22,43,140,61,240,405
1987,Dan Roundfield,PF,33,WSB,36,0,669,90,220,.409,1,5,.200,89,215,.414,.411,57,72,.792,64,106,170,39,11,16,49,77,238
1987,Ron Rowan,SG,24,POR,7,0,16,4,9,.444,1,1,1.000,3,8,.375,.500,3,4,.750,1,0,1,1,4,0,3,1,12
1987,Jeff Ruland,PF,28,PHI,5,2,116,19,28,.679,0,0,,19,28,.679,.679,9,12,.750,12,16,28,10,0,4,10,13,47
1987,Walker Russell,PG,26,IND,48,0,511,64,165,.388,2,16,.125,62,149,.416,.394,27,37,.730,18,37,55,129,20,5,60,62,157
1987,John Salley,C,22,DET,82,2,1463,163,290,.562,0,1,.000,163,289,.564,.562,105,171,.614,108,188,296,54,44,125,74,256,431
1987,Ralph Sampson*,PF,26,HOU,43,32,1326,277,566,.489,0,3,.000,277,563,.492,.489,118,189,.624,88,284,372,120,40,58,126,169,672
1987,Mike Sanders,SF,26,PHO,82,4,1655,357,722,.494,2,17,.118,355,705,.504,.496,143,183,.781,101,170,271,126,61,23,105,210,859
1987,Danny Schayes,C,27,DEN,76,41,1556,210,405,.519,0,0,,210,405,.519,.519,229,294,.779,120,260,380,85,20,74,95,266,649
1987,Russ Schoene,PF,26,SEA,63,0,579,71,190,.374,2,13,.154,69,177,.390,.379,29,46,.630,52,65,117,27,20,11,42,94,173
1987,Detlef Schrempf,SF,24,DAL,81,5,1711,265,561,.472,33,69,.478,232,492,.472,.502,193,260,.742,87,216,303,161,50,16,110,224,756
1987,John Schweitz,SG,26,DET,3,0,7,0,1,.000,0,0,,0,1,.000,.000,0,0,,0,1,1,0,0,0,2,2,0
1987,Byron Scott,SG,25,LAL,82,82,2729,554,1134,.489,65,149,.436,489,985,.496,.517,224,251,.892,63,223,286,281,125,18,144,163,1397
1987,Carey Scurry,SF,24,UTA,69,5,753,123,247,.498,4,13,.308,119,234,.509,.506,94,134,.701,97,101,198,57,55,54,56,124,344
1987,Brad Sellers,PF,24,CHI,80,17,1751,276,606,.455,2,10,.200,274,596,.460,.457,126,173,.728,155,218,373,102,44,68,84,194,680
1987,Purvis Short,SF,29,GSW,34,15,950,240,501,.479,4,17,.235,236,484,.488,.483,137,160,.856,55,82,137,86,45,7,68,103,621
1987,Jerry Sichting,PG,30,BOS,78,15,1566,202,398,.508,7,26,.269,195,372,.524,.516,37,42,.881,22,69,91,187,40,1,61,124,448
1987,Jack Sikma*,C,31,MIL,82,82,2536,390,842,.463,0,2,.000,390,840,.464,.463,265,313,.847,208,614,822,203,88,90,160,328,1045
1987,McKinley Singleton,PG,25,NYK,2,0,10,2,3,.667,0,1,.000,2,2,1.000,.667,0,0,,0,0,0,1,0,0,0,1,4
1987,Scott Skiles,PG,22,MIL,13,0,205,18,62,.290,3,14,.214,15,48,.313,.315,10,12,.833,6,20,26,45,5,1,21,18,49
1987,Clinton Smith,SG,23,GSW,41,0,341,50,117,.427,0,2,.000,50,115,.435,.427,27,36,.750,26,30,56,45,13,1,26,36,127
1987,Derek Smith,SG,25,SAC,52,42,1658,338,757,.446,9,33,.273,329,724,.454,.452,178,228,.781,60,122,182,204,46,23,126,184,863
1987,Keith Smith,SG,22,MIL,42,4,461,57,150,.380,3,9,.333,54,141,.383,.390,21,28,.750,13,19,32,43,25,3,30,74,138
1987,Larry Smith,PF,29,GSW,80,78,2374,297,544,.546,0,1,.000,297,543,.547,.546,113,197,.574,366,551,917,95,71,56,135,295,707
1987,Otis Smith,SG,23,DEN,28,0,168,33,79,.418,0,2,.000,33,77,.429,.418,12,21,.571,17,17,34,22,1,1,19,30,78
1987,Mike Smrek,C,24,LAL,35,3,233,30,60,.500,0,0,,30,60,.500,.500,16,25,.640,13,24,37,5,4,13,19,70,76
1987,Rory Sparrow,PG,28,NYK,80,30,1951,263,590,.446,11,42,.262,252,548,.460,.455,71,89,.798,29,86,115,432,67,6,140,160,608
1987,Terence Stansbury,SG,25,SEA,44,0,375,67,156,.429,11,29,.379,56,127,.441,.465,31,50,.620,8,16,24,57,13,0,29,78,176
1987,Brook Steppe,SG,27,SAC,34,7,665,95,199,.477,3,9,.333,92,190,.484,.485,73,88,.830,21,40,61,81,18,3,54,56,266
1987,Steve Stipanovich,C,26,IND,81,81,2761,382,760,.503,1,4,.250,381,756,.504,.503,307,367,.837,184,486,670,180,106,97,130,304,1072
1987,John Stockton*,PG,24,UTA,82,2,1858,231,463,.499,7,39,.179,224,424,.528,.506,179,229,.782,32,119,151,670,177,14,164,224,648
1987,Jon Sundvold,PG,25,SAS,76,42,1765,365,751,.486,50,149,.336,315,602,.523,.519,70,84,.833,20,78,98,315,35,0,97,109,850
1987,Roy Tarpley,PF,22,DAL,75,1,1405,233,499,.467,1,3,.333,232,496,.468,.468,94,139,.676,180,353,533,52,56,79,101,232,561
1987,Jeff Taylor,SG,27,DET,12,0,44,6,10,.600,0,0,,6,10,.600,.600,9,10,.900,1,3,4,3,2,1,8,4,21
1987,Terry Teagle,SG,26,GSW,82,0,1650,370,808,.458,0,10,.000,370,798,.464,.458,182,234,.778,68,107,175,105,68,13,117,190,922
1987,Reggie Theus,PG,29,SAC,79,76,2872,577,1223,.472,17,78,.218,560,1145,.489,.479,429,495,.867,86,180,266,692,78,16,289,208,1600
1987,David Thirdkill,SF,26,BOS,17,0,89,10,24,.417,0,1,.000,10,23,.435,.417,5,16,.313,5,14,19,2,2,0,5,12,25
1987,Isiah Thomas*,PG,25,DET,81,81,3013,626,1353,.463,19,98,.194,607,1255,.484,.470,400,521,.768,82,237,319,813,153,20,343,251,1671
1987,Bernard Thompson,SF,24,PHO,24,2,331,42,105,.400,0,3,.000,42,102,.412,.400,27,33,.818,20,11,31,18,11,5,16,53,111
1987,Billy Thompson,SF,23,LAL,59,0,762,142,261,.544,0,1,.000,142,260,.546,.544,48,74,.649,69,102,171,60,15,30,61,148,332
1987,LaSalle Thompson,C,25,SAC,82,53,2166,362,752,.481,0,5,.000,362,747,.485,.481,188,255,.737,237,450,687,122,69,126,143,290,912
1987,Mychal Thompson,PF,32,TOT,82,7,1890,359,797,.450,1,2,.500,358,795,.450,.451,219,297,.737,138,274,412,115,45,71,134,202,938
1987,Mychal Thompson,PF,32,SAS,49,6,1210,230,528,.436,1,1,1.000,229,527,.435,.437,144,196,.735,91,185,276,87,31,41,77,117,605
1987,Mychal Thompson,PF,32,LAL,33,1,680,129,269,.480,0,1,.000,129,268,.481,.480,75,101,.743,47,89,136,28,14,30,57,85,333
1987,Bob Thornton,PF,24,NYK,33,4,282,29,67,.433,0,1,.000,29,66,.439,.433,13,20,.650,18,38,56,8,4,3,24,48,71
1987,Otis Thorpe,PF,24,SAC,82,82,2956,567,1050,.540,0,3,.000,567,1047,.542,.540,413,543,.761,259,560,819,201,46,60,189,292,1547
1987,Sedale Threatt,PG,25,TOT,68,8,1446,239,534,.448,7,32,.219,232,502,.462,.454,95,119,.798,26,82,108,259,74,13,89,164,580
1987,Sedale Threatt,PG,25,PHI,28,8,668,108,261,.414,7,16,.438,101,245,.412,.427,42,53,.792,18,39,57,82,32,4,47,76,265
1987,Sedale Threatt,PG,25,CHI,40,0,778,131,273,.480,0,16,.000,131,257,.510,.480,53,66,.803,8,43,51,177,42,9,42,88,315
1987,Wayman Tisdale,PF,22,IND,81,15,2159,458,892,.513,0,2,.000,458,890,.515,.513,258,364,.709,217,258,475,117,50,26,139,293,1174
1987,Andrew Toney,SG,29,PHI,52,12,1058,197,437,.451,22,67,.328,175,370,.473,.476,133,167,.796,16,69,85,188,18,8,112,78,549
1987,Kelly Tripucka,SF,27,UTA,79,76,1865,291,621,.469,19,52,.365,272,569,.478,.484,197,226,.872,54,188,242,243,85,11,167,147,798
1987,Trent Tucker,SG,27,NYK,70,15,1691,325,691,.470,68,161,.422,257,530,.485,.520,77,101,.762,49,86,135,166,116,13,78,169,795
1987,Andre Turner,PG,22,BOS,3,0,18,2,5,.400,0,1,.000,2,4,.500,.400,0,0,,1,1,2,1,0,0,5,1,4
1987,Elston Turner,SF,27,CHI,70,4,936,112,252,.444,1,8,.125,111,244,.455,.446,23,31,.742,34,81,115,102,30,4,31,97,248
1987,Jeff Turner,PF,24,NJN,76,22,1003,151,325,.465,0,1,.000,151,324,.466,.465,76,104,.731,80,117,197,60,33,13,81,200,378
1987,Melvin Turpin,C,26,CLE,64,1,801,169,366,.462,0,0,,169,366,.462,.462,55,77,.714,62,128,190,33,11,40,63,90,393
1987,Terry Tyler,SF,30,SAC,82,48,1930,329,664,.495,1,3,.333,328,661,.496,.496,101,140,.721,116,212,328,73,55,78,78,151,760
1987,Darnell Valentine,PG,27,LAC,65,52,1759,275,671,.410,13,56,.232,262,615,.426,.420,163,200,.815,38,112,150,447,116,10,167,148,726
1987,Kiki Vandeweghe,SF,28,POR,79,79,3029,808,1545,.523,39,81,.481,769,1464,.525,.536,467,527,.886,86,165,251,220,52,17,139,137,2122
1987,Nick Vanos,C,23,PHO,57,14,640,65,158,.411,0,2,.000,65,156,.417,.411,38,59,.644,67,113,180,43,19,23,48,94,168
1987,Pete Verhoeven,PF,27,IND,5,0,44,5,14,.357,0,0,,5,14,.357,.357,0,0,,2,5,7,2,2,1,0,11,10
1987,Jay Vincent,SF,27,WSB,51,17,1386,274,613,.447,0,3,.000,274,610,.449,.447,130,169,.769,69,141,210,85,40,17,77,127,678
1987,Sam Vincent,PG,23,BOS,46,5,374,60,136,.441,0,0,,60,136,.441,.441,51,55,.927,5,22,27,59,13,1,33,33,171
1987,Danny Vranes,SF,28,PHI,58,6,817,59,138,.428,1,5,.200,58,133,.436,.431,21,45,.467,51,95,146,30,35,25,26,127,140
1987,Granville Waiters,C,26,CHI,44,26,534,40,93,.430,0,1,.000,40,92,.435,.430,5,9,.556,38,49,87,22,10,31,16,83,85
1987,Darrell Walker,PG,25,DEN,81,25,2020,358,742,.482,0,4,.000,358,738,.485,.482,272,365,.745,157,170,327,282,120,37,187,229,988
1987,Kenny Walker,SF,22,NYK,68,64,1719,285,581,.491,0,4,.000,285,577,.494,.491,140,185,.757,118,220,338,75,49,49,75,236,710
1987,Bill Walton*,C,34,BOS,10,0,112,10,26,.385,0,0,,10,26,.385,.385,8,15,.533,11,20,31,9,1,10,15,23,28
1987,Chris Washburn,C,21,GSW,35,2,385,57,145,.393,0,1,.000,57,144,.396,.393,18,51,.353,36,65,101,16,6,8,39,51,132
1987,Pearl Washington,PG,23,NJN,72,61,1600,257,538,.478,4,24,.167,253,514,.492,.481,98,125,.784,37,92,129,301,92,7,175,184,616
1987,Spud Webb,PG,23,ATL,33,0,532,71,162,.438,1,6,.167,70,156,.449,.441,80,105,.762,6,54,60,167,34,2,70,65,223
1987,Marvin Webster,C,34,MIL,15,0,102,10,19,.526,1,1,1.000,9,18,.500,.553,6,8,.750,12,14,26,3,3,7,8,17,27
1987,Scott Wedman,SF,34,BOS,6,2,78,9,27,.333,1,2,.500,8,25,.320,.352,1,2,.500,3,6,9,6,2,2,3,6,20
1987,Bill Wennington,C,23,DAL,58,0,560,56,132,.424,0,2,.000,56,130,.431,.424,45,60,.750,53,76,129,24,13,10,39,95,157
1987,Mark West,C,26,CLE,78,13,1333,209,385,.543,0,2,.000,209,383,.546,.543,89,173,.514,126,213,339,41,22,81,106,229,507
1987,Ennis Whatley,PG,24,WSB,73,72,1816,246,515,.478,0,2,.000,246,513,.480,.478,126,165,.764,58,136,194,392,92,10,138,172,618
1987,Rory White,SF,27,LAC,68,35,1545,265,552,.480,0,3,.000,265,549,.483,.480,94,144,.653,90,104,194,79,47,19,73,159,624
1987,Jerome Whitehead,C,30,GSW,73,1,937,147,327,.450,0,1,.000,147,326,.451,.450,79,113,.699,110,152,262,24,16,12,50,175,373
1987,Mitchell Wiggins,SG,27,HOU,32,19,788,153,350,.437,0,5,.000,153,345,.443,.437,49,65,.754,74,59,133,76,44,3,50,82,355
1987,Dominique Wilkins*,SF,27,ATL,79,79,2969,828,1787,.463,31,106,.292,797,1681,.474,.472,607,742,.818,210,284,494,261,117,51,215,149,2294
1987,Eddie Lee Wilkins,PF,24,NYK,24,10,454,56,127,.441,0,1,.000,56,126,.444,.441,27,58,.466,45,62,107,6,9,2,28,67,139
1987,Gerald Wilkins,SG,23,NYK,80,73,2758,633,1302,.486,26,74,.351,607,1228,.494,.496,235,335,.701,120,174,294,354,88,18,214,165,1527
1987,Buck Williams,PF,26,NJN,82,82,2976,521,936,.557,0,1,.000,521,935,.557,.557,430,588,.731,322,701,1023,129,78,91,280,315,1472
1987,Gus Williams,SG,33,ATL,33,0,481,53,146,.363,5,18,.278,48,128,.375,.380,27,40,.675,8,32,40,139,17,5,54,53,138
1987,Herb Williams,PF,28,IND,74,67,2526,451,939,.480,0,9,.000,451,930,.485,.480,199,269,.740,143,400,543,174,59,93,145,255,1101
1987,Hot Rod Williams,PF,24,CLE,80,80,2714,435,897,.485,0,1,.000,435,896,.485,.485,298,400,.745,222,407,629,154,58,167,139,197,1168
1987,John Williams,SF,20,WSB,78,6,1773,283,624,.454,8,36,.222,275,588,.468,.460,144,223,.646,130,236,366,191,129,30,122,173,718
1987,Kevin Williams,SG,25,SEA,65,0,703,132,296,.446,0,7,.000,132,289,.457,.446,55,66,.833,47,36,83,66,45,8,63,154,319
1987,Pete Williams,PF,21,DEN,5,0,10,1,2,.500,0,0,,1,2,.500,.500,0,0,,0,1,1,1,0,0,1,1,2
1987,Ray Williams,PG,32,NJN,32,14,800,131,290,.452,7,28,.250,124,262,.473,.464,49,60,.817,26,49,75,185,38,9,94,111,318
1987,Kevin Willis,PF,24,ATL,81,81,2626,538,1003,.536,1,4,.250,537,999,.538,.537,227,320,.709,321,528,849,62,65,61,173,313,1304
1987,Michael Wilson,SG-PG,27,TOT,7,0,45,3,10,.300,0,0,,3,10,.300,.300,2,2,1.000,1,3,4,7,1,0,5,10,8
1987,Michael Wilson,SG,27,NJN,5,0,43,3,8,.375,0,0,,3,8,.375,.375,2,2,1.000,1,3,4,6,1,0,4,9,8
1987,Michael Wilson,PG,27,ATL,2,0,2,0,2,.000,0,0,,0,2,.000,.000,0,0,,0,0,0,1,0,0,1,1,0
1987,Othell Wilson,PG,25,SAC,53,2,789,82,185,.443,3,18,.167,79,167,.473,.451,43,54,.796,28,53,81,207,42,4,77,67,210
1987,David Wingate,SG,23,PHI,77,9,1612,259,602,.430,13,52,.250,246,550,.447,.441,149,201,.741,70,86,156,155,93,19,128,169,680
1987,Randy Wittman,SG,27,ATL,71,65,2049,398,792,.503,4,12,.333,394,780,.505,.505,100,127,.787,30,94,124,211,39,16,88,107,900
1987,Al Wood,SG,28,DAL,54,0,657,121,310,.390,7,25,.280,114,285,.400,.402,109,139,.784,39,55,94,34,19,11,34,83,358
1987,Leon Wood,PG,24,NJN,76,7,1733,187,501,.373,60,200,.300,127,301,.422,.433,123,154,.799,23,97,120,370,48,3,108,126,557
1987,Mike Woodson,SG,28,LAC,74,66,2126,494,1130,.437,34,123,.276,460,1007,.457,.452,240,290,.828,68,94,162,196,100,16,168,201,1262
1987,Orlando Woolridge,SF,27,NJN,75,53,2638,556,1067,.521,1,8,.125,555,1059,.524,.522,438,564,.777,118,249,367,261,54,86,213,243,1551
1987,James Worthy*,SF,25,LAL,82,82,2819,651,1207,.539,0,13,.000,651,1194,.545,.539,292,389,.751,158,308,466,226,108,83,168,206,1594
1987,Brad Wright,PF,24,NYK,14,0,138,20,46,.435,0,1,.000,20,45,.444,.435,12,28,.429,25,28,53,1,3,6,13,20,52
1987,Danny Young,PG,24,SEA,73,26,1482,132,288,.458,29,79,.367,103,209,.493,.509,59,71,.831,23,90,113,353,74,3,85,72,352
1987,Perry Young,SG,23,TOT,9,0,72,6,21,.286,0,0,,6,21,.286,.286,1,2,.500,3,5,8,7,5,1,4,14,13
1987,Perry Young,SG,23,CHI,5,0,20,2,4,.500,0,0,,2,4,.500,.500,1,2,.500,0,1,1,0,1,0,1,3,5
1987,Perry Young,SG,23,POR,4,0,52,4,17,.235,0,0,,4,17,.235,.235,0,0,,3,4,7,7,4,1,3,11,8
1988,Kareem Abdul-Jabbar*,C,40,LAL,80,80,2308,480,903,.532,0,1,.000,480,902,.532,.532,205,269,.762,118,360,478,135,48,92,159,216,1165
1988,Mark Acres,C,25,BOS,79,5,1151,108,203,.532,0,0,,108,203,.532,.532,71,111,.640,105,165,270,42,29,27,54,198,287
1988,Alvan Adams,C,33,PHO,82,25,1646,251,506,.496,1,2,.500,250,504,.496,.497,108,128,.844,118,247,365,183,82,41,140,245,611
1988,Michael Adams,PG,25,DEN,82,75,2778,416,927,.449,139,379,.367,277,548,.505,.524,166,199,.834,40,183,223,503,168,16,144,138,1137
1988,Mark Aguirre,SF,28,DAL,77,77,2610,746,1571,.475,52,172,.302,694,1399,.496,.491,388,504,.770,182,252,434,278,70,57,203,223,1932
1988,Danny Ainge,SG,28,BOS,81,81,3018,482,982,.491,148,357,.415,334,625,.534,.566,158,180,.878,59,190,249,503,115,17,153,203,1270
1988,Mark Alarie,PF,24,WSB,63,0,769,144,300,.480,4,18,.222,140,282,.496,.487,35,49,.714,70,90,160,39,10,12,50,107,327
1988,Steve Alford,PG,23,DAL,28,0,197,21,55,.382,1,8,.125,20,47,.426,.391,16,17,.941,3,20,23,23,17,3,12,23,59
1988,Greg Anderson,PF,23,SAS,82,45,1984,379,756,.501,1,5,.200,378,751,.503,.502,198,328,.604,161,352,513,79,54,122,143,228,957
1988,Richard Anderson,PF,27,TOT,74,3,1350,171,439,.390,48,150,.320,123,289,.426,.444,58,77,.753,91,212,303,112,51,16,61,137,448
1988,Richard Anderson,PF,27,HOU,12,0,53,11,26,.423,6,15,.400,5,11,.455,.538,4,5,.800,9,8,17,4,1,0,1,4,32
1988,Richard Anderson,PF,27,POR,62,3,1297,160,413,.387,42,135,.311,118,278,.424,.438,54,72,.750,82,204,286,108,50,16,60,133,416
1988,Ron Anderson,SF,29,IND,74,1,1097,217,436,.498,0,2,.000,217,434,.500,.498,108,141,.766,89,127,216,78,41,6,73,98,542
1988,Joe Arlauckas,SF,22,SAC,9,0,85,14,43,.326,0,0,,14,43,.326,.326,6,8,.750,6,7,13,8,3,4,4,16,34
1988,Vincent Askew,SG,21,PHI,14,2,234,22,74,.297,0,0,,22,74,.297,.297,8,11,.727,6,16,22,33,10,6,12,12,52
1988,John Bagley,PG,27,NJN,82,74,2774,393,896,.439,47,161,.292,346,735,.471,.465,148,180,.822,61,196,257,479,110,10,201,162,981
1988,James Bailey,PF,30,PHO,65,0,869,109,241,.452,0,4,.000,109,237,.460,.452,70,89,.787,73,137,210,42,17,28,70,180,288
1988,Thurl Bailey,SF,26,UTA,82,10,2804,633,1286,.492,1,3,.333,632,1283,.493,.493,337,408,.826,134,397,531,158,49,125,190,186,1604
1988,Charles Barkley*,PF,24,PHI,80,80,3170,753,1283,.587,44,157,.280,709,1126,.630,.604,714,951,.751,385,566,951,254,100,103,304,278,2264
1988,John Battle,SG,25,ATL,67,1,1227,278,613,.454,16,41,.390,262,572,.458,.467,141,188,.750,26,87,113,158,31,5,75,84,713
1988,William Bedford,C,24,DET,38,0,298,44,101,.436,0,0,,44,101,.436,.436,13,23,.565,27,38,65,4,8,17,19,47,101
1988,Benoit Benjamin,C,23,LAC,66,59,2171,340,693,.491,0,8,.000,340,685,.496,.491,180,255,.706,112,418,530,172,50,225,223,203,860
1988,Kent Benson,C,33,CLE,2,0,12,2,2,1.000,0,0,,2,2,1.000,1.000,1,2,.500,0,1,1,0,1,1,2,2,5
1988,Walter Berry,SF,23,SAS,73,56,1922,540,960,.563,0,0,,540,960,.563,.563,192,320,.600,176,219,395,110,55,63,162,207,1272
1988,Larry Bird*,SF,31,BOS,76,75,2965,881,1672,.527,98,237,.414,783,1435,.546,.556,415,453,.916,108,595,703,467,125,57,213,157,2275
1988,Otis Birdsong,SG,32,NJN,67,59,1882,337,736,.458,9,25,.360,328,711,.461,.464,47,92,.511,73,94,167,222,54,11,129,143,730
1988,Uwe Blab,C,25,DAL,73,1,658,58,132,.439,0,0,,58,132,.439,.439,46,65,.708,52,82,134,35,8,29,49,108,162
1988,Rolando Blackman,SG,28,DAL,71,69,2580,497,1050,.473,0,5,.000,497,1045,.476,.473,331,379,.873,82,164,246,262,64,18,144,112,1325
1988,Nate Blackwell,PG,22,SAS,10,0,112,15,41,.366,2,11,.182,13,30,.433,.390,5,6,.833,2,4,6,18,3,0,8,16,37
1988,Muggsy Bogues,PG,23,WSB,79,14,1628,166,426,.390,3,16,.188,163,410,.398,.393,58,74,.784,35,101,136,404,127,3,101,138,393
1988,Manute Bol,C,25,WSB,77,4,1136,75,165,.455,0,1,.000,75,164,.457,.455,26,49,.531,72,203,275,13,11,208,35,160,176
1988,Dudley Bradley,SG,30,TOT,65,15,1437,156,365,.427,37,102,.363,119,263,.452,.478,74,97,.763,25,102,127,151,114,43,88,172,423
1988,Dudley Bradley,SG,30,MIL,2,0,5,0,1,.000,0,1,.000,0,0,,.000,0,0,,0,1,1,1,0,0,0,2,0
1988,Dudley Bradley,SG,30,NJN,63,15,1432,156,364,.429,37,101,.366,119,263,.452,.479,74,97,.763,25,101,126,150,114,43,88,170,423
1988,Adrian Branch,SF,24,NJN,20,3,308,56,134,.418,1,5,.200,55,129,.426,.422,20,23,.870,20,28,48,16,16,11,29,41,133
1988,Randy Breuer,C,27,MIL,81,73,2258,390,788,.495,0,0,,390,788,.495,.495,188,286,.657,191,360,551,103,46,107,107,198,968
1988,Frank Brickowski,C,28,SAS,70,68,2227,425,805,.528,1,5,.200,424,800,.530,.529,268,349,.768,167,316,483,266,74,36,207,275,1119
1988,Michael Brooks,SF,29,DEN,16,0,133,20,49,.408,0,0,,20,49,.408,.408,3,4,.750,19,25,44,13,4,1,12,21,43
1988,Mike Brown,C,24,CHI,46,27,591,78,174,.448,0,1,.000,78,173,.451,.448,41,71,.577,66,93,159,28,11,4,38,85,197
1988,Steve Burtt,SG,25,LAC,19,0,312,62,138,.449,0,4,.000,62,134,.463,.449,47,69,.681,6,21,27,38,10,5,40,56,171
1988,Michael Cage,PF,26,LAC,72,70,2660,360,766,.470,0,1,.000,360,765,.471,.470,326,474,.688,371,567,938,110,91,58,160,194,1046
1988,Tony Campbell,SF,25,LAL,13,1,242,57,101,.564,1,3,.333,56,98,.571,.569,28,39,.718,8,19,27,15,11,2,26,41,143
1988,Rick Carlisle,SG,28,NYK,26,0,204,29,67,.433,6,17,.353,23,50,.460,.478,10,11,.909,6,7,13,32,11,4,22,39,74
1988,Antoine Carr,PF,26,ATL,80,2,1483,281,517,.544,1,4,.250,280,513,.546,.544,142,182,.780,94,195,289,103,38,83,116,272,705
1988,Joe Barry Carroll,C,29,TOT,77,30,2004,402,924,.435,0,2,.000,402,922,.436,.435,172,225,.764,131,358,489,113,50,106,164,195,976
1988,Joe Barry Carroll,C,29,GSW,14,14,408,79,209,.378,0,1,.000,79,208,.380,.378,59,74,.797,21,72,93,19,13,25,43,46,217
1988,Joe Barry Carroll,C,29,HOU,63,16,1596,323,715,.452,0,1,.000,323,714,.452,.452,113,151,.748,110,286,396,94,37,81,121,149,759
1988,Bill Cartwright,C,30,NYK,82,4,1676,287,528,.544,0,0,,287,528,.544,.544,340,426,.798,127,257,384,85,43,43,135,234,914
1988,Terry Catledge,PF,24,WSB,70,40,1610,296,585,.506,0,2,.000,296,583,.508,.506,154,235,.655,180,217,397,63,33,9,101,172,746
1988,Tom Chambers,PF,28,SEA,82,82,2680,611,1364,.448,33,109,.303,578,1255,.461,.460,419,519,.807,135,355,490,212,87,53,209,297,1674
1988,Maurice Cheeks*,PG,31,PHI,79,79,2871,428,865,.495,3,22,.136,425,843,.504,.497,227,275,.825,59,194,253,635,167,22,160,116,1086
1988,Ben Coleman,PF,26,TOT,70,24,1498,226,453,.499,0,3,.000,226,450,.502,.499,141,185,.762,116,234,350,62,43,41,127,230,593
1988,Ben Coleman,PF,26,NJN,27,10,657,116,240,.483,0,2,.000,116,238,.487,.483,65,84,.774,58,115,173,39,28,16,72,110,297
1988,Ben Coleman,PF,26,PHI,43,14,841,110,213,.516,0,1,.000,110,212,.519,.516,76,101,.752,58,119,177,23,15,25,55,120,296
1988,Norris Coleman,SF,26,LAC,29,11,431,66,191,.346,1,2,.500,65,189,.344,.348,20,36,.556,36,45,81,13,11,6,16,51,153
1988,Steve Colter,PG,25,TOT,68,53,1513,203,441,.460,3,10,.300,200,431,.464,.464,75,95,.789,58,115,173,261,62,14,88,132,484
1988,Steve Colter,PG,25,PHI,12,0,152,15,40,.375,0,0,,15,40,.375,.375,7,9,.778,7,11,18,26,6,0,11,20,37
1988,Steve Colter,PG,25,WSB,56,53,1361,188,401,.469,3,10,.300,185,391,.473,.473,68,86,.791,51,104,155,235,56,14,77,112,447
1988,Dallas Comegys,PF,23,NJN,75,17,1122,156,363,.430,0,1,.000,156,362,.431,.430,106,150,.707,54,164,218,65,36,70,116,175,418
1988,Lester Conner,PG,28,HOU,52,3,399,50,108,.463,0,7,.000,50,101,.495,.463,32,41,.780,20,18,38,59,38,1,33,31,132
1988,Jeff Cook,PF,31,PHO,33,0,359,14,59,.237,0,1,.000,14,58,.241,.237,23,28,.821,37,69,106,14,9,8,14,64,51
1988,Michael Cooper,SG,31,LAL,61,8,1793,189,482,.392,57,178,.320,132,304,.434,.451,97,113,.858,50,178,228,289,66,26,101,136,532
1988,Wayne Cooper,C,31,DEN,45,32,865,118,270,.437,0,1,.000,118,269,.439,.437,50,67,.746,98,172,270,30,12,94,59,145,286
1988,Tyrone Corbin,SF,25,TOT,84,5,1739,257,525,.490,1,6,.167,256,519,.493,.490,110,138,.797,127,223,350,115,72,18,104,181,625
1988,Tyrone Corbin,SF,25,CLE,54,4,1148,158,322,.491,0,3,.000,158,319,.495,.491,77,98,.786,79,141,220,56,42,15,66,128,393
1988,Tyrone Corbin,SF,25,PHO,30,1,591,99,203,.488,1,3,.333,98,200,.490,.490,33,40,.825,48,82,130,59,30,3,38,53,232
1988,Dave Corzine,C,31,CHI,80,32,2328,344,715,.481,1,9,.111,343,706,.486,.482,115,153,.752,170,357,527,154,36,95,109,149,804
1988,Winston Crite,SF,22,PHO,29,0,258,34,68,.500,0,0,,34,68,.500,.500,19,25,.760,27,37,64,15,5,8,25,42,87
1988,Pat Cummings,PF,31,NYK,62,9,946,140,307,.456,0,1,.000,140,306,.458,.456,59,80,.738,82,153,235,37,20,10,65,143,339
1988,Terry Cummings,PF,26,MIL,76,76,2629,675,1392,.485,1,3,.333,674,1389,.485,.485,270,406,.665,184,369,553,181,78,46,170,274,1621
1988,Earl Cureton,PF,30,LAC,69,11,1128,133,310,.429,0,3,.000,133,307,.433,.429,33,63,.524,97,174,271,63,32,36,58,135,299
1988,Dell Curry,SG,23,CLE,79,8,1499,340,742,.458,28,81,.346,312,661,.472,.477,79,101,.782,43,123,166,149,94,22,108,128,787
1988,Quintin Dailey,SG,27,LAC,67,7,1282,328,755,.434,2,12,.167,326,743,.439,.436,243,313,.776,62,92,154,109,69,4,123,128,901
1988,Adrian Dantley*,SF,32,DET,69,50,2144,444,863,.514,0,2,.000,444,861,.516,.514,492,572,.860,84,143,227,171,39,10,135,144,1380
1988,Brad Daugherty,C,22,CLE,79,78,2957,551,1081,.510,0,2,.000,551,1079,.511,.510,378,528,.716,151,514,665,333,48,56,267,235,1480
1988,Brad Davis,PG,32,DAL,75,12,1480,208,415,.501,30,74,.405,178,341,.522,.537,91,108,.843,18,84,102,303,51,18,91,149,537
1988,Charles Davis,SF,29,TOT,21,0,226,48,115,.417,1,17,.059,47,98,.480,.422,7,10,.700,16,25,41,20,2,4,18,29,104
1988,Charles Davis,SF,29,MIL,5,0,39,6,18,.333,0,2,.000,6,16,.375,.333,0,0,,1,2,3,3,2,1,5,4,12
1988,Charles Davis,SF,29,SAS,16,0,187,42,97,.433,1,15,.067,41,82,.500,.438,7,10,.700,15,23,38,17,0,3,13,25,92
1988,Walter Davis,SF,33,PHO,68,48,1951,488,1031,.473,36,96,.375,452,935,.483,.491,205,231,.887,32,127,159,278,86,3,126,131,1217
1988,Darryl Dawkins,C,31,TOT,6,0,33,2,9,.222,0,0,,2,9,.222,.222,6,15,.400,2,3,5,2,0,2,7,14,10
1988,Darryl Dawkins,C,31,UTA,4,0,26,1,7,.143,0,0,,1,7,.143,.143,4,12,.333,2,3,5,1,0,1,4,10,6
1988,Darryl Dawkins,C,31,DET,2,0,7,1,2,.500,0,0,,1,2,.500,.500,2,3,.667,0,0,0,1,0,1,3,4,4
1988,Johnny Dawkins,PG,24,SAS,65,61,2179,405,835,.485,19,61,.311,386,774,.499,.496,198,221,.896,66,138,204,480,88,2,154,95,1027
1988,Darren Daye,SF,27,BOS,47,8,655,112,217,.516,0,1,.000,112,216,.519,.516,59,87,.678,30,46,76,71,29,4,44,68,283
1988,James Donaldson,C,30,DAL,81,81,2523,212,380,.558,0,0,,212,380,.558,.558,147,189,.778,247,508,755,66,40,104,113,175,571
1988,Billy Donovan,PG,22,NYK,44,0,364,44,109,.404,0,7,.000,44,102,.431,.404,17,21,.810,5,20,25,87,16,1,42,33,105
1988,Greg Dreiling,C,25,IND,20,0,74,8,17,.471,0,0,,8,17,.471,.471,18,26,.692,3,14,17,5,2,4,11,19,34
1988,Larry Drew,PG,29,LAC,74,51,2024,328,720,.456,26,90,.289,302,630,.479,.474,83,108,.769,21,98,119,383,65,0,152,114,765
1988,Clyde Drexler*,SG,25,POR,81,80,3060,849,1679,.506,11,52,.212,838,1627,.515,.509,476,587,.811,261,272,533,467,203,52,236,250,2185
1988,Kevin Duckworth,C,23,POR,78,50,2223,450,907,.496,0,0,,450,907,.496,.496,331,430,.770,224,352,576,66,31,32,177,280,1231
1988,Chris Dudley,C,22,CLE,55,1,513,65,137,.474,0,0,,65,137,.474,.474,40,71,.563,74,70,144,23,13,19,31,87,170
1988,Joe Dumars*,SG,24,DET,82,82,2732,453,960,.472,4,19,.211,449,941,.477,.474,251,308,.815,63,137,200,387,87,15,172,155,1161
1988,T.R. Dunn,SG,32,DEN,82,1,1534,70,156,.449,0,1,.000,70,155,.452,.449,40,52,.769,110,130,240,87,101,11,26,152,180
1988,Mark Eaton,C,31,UTA,82,82,2731,226,541,.418,0,0,,226,541,.418,.418,119,191,.623,230,487,717,55,41,304,131,320,571
1988,Franklin Edwards,PG,28,SAC,16,11,414,54,115,.470,0,2,.000,54,113,.478,.470,24,32,.750,4,15,19,92,10,1,47,10,132
1988,James Edwards,C,32,TOT,69,44,1705,302,643,.470,0,1,.000,302,642,.470,.470,210,321,.654,119,293,412,78,16,37,130,216,814
1988,James Edwards,C,32,PHO,43,42,1377,254,542,.469,0,1,.000,254,541,.470,.469,165,260,.635,97,238,335,73,14,32,108,159,673
1988,James Edwards,C,32,DET,26,2,328,48,101,.475,0,0,,48,101,.475,.475,45,61,.738,22,55,77,5,2,5,22,57,141
1988,Craig Ehlo,SG,26,CLE,79,27,1709,226,485,.466,22,64,.344,204,421,.485,.489,89,132,.674,86,188,274,206,82,30,107,182,563
1988,Dale Ellis,SG,27,SEA,75,73,2790,764,1519,.503,107,259,.413,657,1260,.521,.538,303,395,.767,167,173,340,197,74,11,172,221,1938
1988,Chris Engler,C,28,NJN,54,0,399,36,88,.409,0,0,,36,88,.409,.409,31,35,.886,32,66,98,15,9,6,29,73,103
1988,Alex English*,SF,34,DEN,80,80,2818,843,1704,.495,0,6,.000,843,1698,.496,.495,314,379,.828,166,207,373,377,70,23,181,193,2000
1988,Mike Evans,PG,32,DEN,56,0,656,139,307,.453,36,91,.396,103,216,.477,.511,30,37,.811,9,39,48,81,34,6,43,78,344
1988,Patrick Ewing*,C,25,NYK,82,82,2546,656,1183,.555,0,3,.000,656,1180,.556,.555,341,476,.716,245,431,676,125,104,245,287,332,1653
1988,Jim Farmer,SG,23,DAL,30,0,157,26,69,.377,0,6,.000,26,63,.413,.377,9,10,.900,9,9,18,16,3,1,22,18,61
1988,Dave Feitl,C,25,GSW,70,19,1128,182,404,.450,0,4,.000,182,400,.455,.450,94,134,.701,83,252,335,53,15,9,87,146,458
1988,Kenny Fields,SF,25,LAC,7,0,154,16,36,.444,0,0,,16,36,.444,.444,20,26,.769,13,16,29,10,5,2,19,17,52
1988,Vern Fleming,PG,25,IND,80,80,2733,442,845,.523,0,13,.000,442,832,.531,.523,227,283,.802,106,258,364,568,115,11,175,225,1111
1988,Sleepy Floyd,PG,27,TOT,77,73,2514,420,969,.433,14,72,.194,406,897,.453,.441,301,354,.850,77,219,296,544,95,12,223,190,1155
1988,Sleepy Floyd,PG,27,GSW,18,18,680,132,301,.439,1,20,.050,131,281,.466,.440,116,139,.835,26,65,91,178,27,2,67,46,381
1988,Sleepy Floyd,PG,27,HOU,59,55,1834,288,668,.431,13,52,.250,275,616,.446,.441,185,215,.860,51,154,205,366,68,10,156,144,774
1988,Tellis Frank,PF,22,GSW,78,29,1597,242,565,.428,0,1,.000,242,564,.429,.428,150,207,.725,95,235,330,111,53,23,109,267,634
1988,World B. Free,SG,34,HOU,58,0,682,143,350,.409,8,35,.229,135,315,.429,.420,80,100,.800,14,30,44,60,20,3,49,74,374
1988,Kevin Gamble,SF,22,POR,9,0,19,0,3,.000,0,1,.000,0,2,.000,.000,0,0,,2,1,3,1,2,0,2,2,0
1988,Winston Garland,PG,23,GSW,67,62,2122,340,775,.439,13,39,.333,327,736,.444,.447,138,157,.879,68,159,227,429,116,7,167,188,831
1988,Armen Gilliam,PF,23,PHO,55,53,1807,342,720,.475,0,0,,342,720,.475,.475,131,193,.679,134,300,434,72,58,29,123,143,815
1988,Artis Gilmore*,C,38,TOT,71,27,893,99,181,.547,0,0,,99,181,.547,.547,67,128,.523,69,142,211,21,15,30,67,148,265
1988,Artis Gilmore*,C,38,CHI,24,23,372,41,80,.513,0,0,,41,80,.513,.513,19,37,.514,15,48,63,9,5,12,28,54,101
1988,Artis Gilmore*,C,38,BOS,47,4,521,58,101,.574,0,0,,58,101,.574,.574,48,91,.527,54,94,148,12,10,18,39,94,164
1988,Mike Gminski,C,28,TOT,81,81,2961,505,1126,.448,0,2,.000,505,1124,.449,.448,355,392,.906,245,569,814,139,64,118,177,176,1365
1988,Mike Gminski,C,28,NJN,34,34,1194,215,474,.454,0,2,.000,215,472,.456,.454,143,166,.861,82,238,320,55,28,33,83,78,573
1988,Mike Gminski,C,28,PHI,47,47,1767,290,652,.445,0,0,,290,652,.445,.445,212,226,.938,163,331,494,84,36,85,94,98,792
1988,Lancaster Gordon,SG,25,LAC,8,0,65,11,31,.355,0,0,,11,31,.355,.355,6,6,1.000,2,2,4,7,1,2,4,8,28
1988,Horace Grant,PF,22,CHI,81,6,1827,254,507,.501,0,2,.000,254,505,.503,.501,114,182,.626,155,292,447,89,51,53,86,221,622
1988,Stuart Gray,C,24,IND,74,0,807,90,193,.466,0,1,.000,90,192,.469,.466,44,73,.603,70,180,250,44,11,32,50,152,224
1988,A.C. Green,PF,24,LAL,82,64,2636,322,640,.503,0,2,.000,322,638,.505,.503,293,379,.773,245,465,710,93,87,45,120,204,937
1988,Rickey Green,PG,33,UTA,81,3,1116,157,370,.424,4,19,.211,153,351,.436,.430,75,83,.904,14,66,80,300,57,1,94,83,393
1988,Sidney Green,PF,27,NYK,82,65,2049,258,585,.441,0,2,.000,258,583,.443,.441,126,190,.663,221,421,642,93,65,32,148,318,642
1988,Dave Greenwood,PF,30,SAS,45,40,1236,151,328,.460,0,2,.000,151,326,.463,.460,83,111,.748,92,208,300,97,33,22,74,134,385
1988,Claude Gregory,PF,29,LAC,23,2,313,61,134,.455,0,1,.000,61,133,.459,.455,12,36,.333,37,58,95,16,9,13,22,37,134
1988,Darrell Griffith,SG,29,UTA,52,11,1052,251,585,.429,28,102,.275,223,483,.462,.453,59,92,.641,36,91,127,91,52,5,67,102,589
1988,Pétur Guðmundsson,C,29,SAS,69,9,1017,139,280,.496,0,1,.000,139,279,.498,.496,117,145,.807,93,230,323,86,18,61,103,197,395
1988,Bob Hansen,SG,27,UTA,81,51,1796,316,611,.517,32,97,.330,284,514,.553,.543,113,152,.743,64,123,187,175,65,5,91,193,777
1988,Bill Hanzlik,SF,30,DEN,77,0,1334,109,287,.380,3,16,.188,106,271,.391,.385,129,163,.791,39,132,171,166,64,17,95,185,350
1988,Derek Harper,PG,26,DAL,82,82,3032,536,1167,.459,60,192,.313,476,975,.488,.485,261,344,.759,71,175,246,634,168,35,190,164,1393
1988,Ron Harper,SG,24,CLE,57,52,1830,340,732,.464,3,20,.150,337,712,.473,.467,196,278,.705,64,159,223,281,122,52,158,157,879
1988,Steve Harris,SG,24,TOT,58,26,1084,223,487,.458,0,7,.000,223,480,.465,.458,89,113,.788,53,73,126,87,50,8,56,89,535
1988,Steve Harris,SG,24,HOU,14,10,199,34,86,.395,0,1,.000,34,85,.400,.395,15,16,.938,12,9,21,17,8,2,6,15,83
1988,Steve Harris,SG,24,GSW,44,16,885,189,401,.471,0,6,.000,189,395,.478,.471,74,97,.763,41,64,105,70,42,6,50,74,452
1988,Scott Hastings,PF,27,ATL,55,0,403,40,82,.488,5,12,.417,35,70,.500,.518,25,27,.926,27,70,97,16,8,10,14,67,110
1988,Dave Henderson,SG,23,PHI,22,1,351,47,116,.405,0,1,.000,47,115,.409,.405,32,47,.681,11,24,35,34,12,5,40,41,126
1988,Gerald Henderson,PG,32,TOT,75,5,1505,194,453,.428,69,163,.423,125,290,.431,.504,138,170,.812,27,80,107,231,69,5,133,187,595
1988,Gerald Henderson,PG,32,NYK,6,2,69,5,14,.357,2,4,.500,3,10,.300,.429,2,2,1.000,1,9,10,13,2,0,8,14,14
1988,Gerald Henderson,PG,32,PHI,69,3,1436,189,439,.431,67,159,.421,122,280,.436,.507,136,168,.810,26,71,97,218,67,5,125,173,581
1988,Kevin Henderson,SG,23,TOT,17,2,190,21,53,.396,0,1,.000,21,52,.404,.396,15,26,.577,9,12,21,23,8,0,17,26,57
1988,Kevin Henderson,SG,23,GSW,12,2,170,19,48,.396,0,1,.000,19,47,.404,.396,10,14,.714,6,11,17,21,8,0,15,24,48
1988,Kevin Henderson,SG,23,CLE,5,0,20,2,5,.400,0,0,,2,5,.400,.400,5,12,.417,3,1,4,2,0,0,2,2,9
1988,Conner Henry,SG,24,TOT,39,2,433,62,150,.413,20,45,.444,42,105,.400,.480,39,47,.830,13,36,49,67,12,5,39,37,183
1988,Conner Henry,SG,24,BOS,10,0,81,11,28,.393,3,8,.375,8,20,.400,.446,9,10,.900,2,8,10,12,1,1,9,11,34
1988,Conner Henry,SG,24,MIL,14,2,145,13,41,.317,2,6,.333,11,35,.314,.341,4,7,.571,5,14,19,29,4,1,14,11,32
1988,Conner Henry,SG,24,SAC,15,0,207,38,81,.469,15,31,.484,23,50,.460,.562,26,30,.867,6,14,20,26,7,3,16,15,117
1988,Rod Higgins,SF,28,GSW,68,67,2188,381,725,.526,19,39,.487,362,686,.528,.539,273,322,.848,94,199,293,188,70,31,111,188,1054
1988,Roy Hinson,SF,26,TOT,77,57,2592,453,930,.487,0,2,.000,453,928,.488,.487,272,351,.775,159,358,517,99,69,140,169,275,1178
1988,Roy Hinson,SF,26,PHI,29,10,845,123,272,.452,0,1,.000,123,271,.454,.452,89,124,.718,53,116,169,27,24,68,63,90,335
1988,Roy Hinson,SF,26,NJN,48,47,1747,330,658,.502,0,1,.000,330,657,.502,.502,183,227,.806,106,242,348,72,45,72,106,185,843
1988,Craig Hodges,SG,27,TOT,66,0,1445,242,523,.463,86,175,.491,156,348,.448,.545,59,71,.831,19,59,78,153,46,2,77,118,629
1988,Craig Hodges,SG,27,MIL,43,0,983,155,345,.449,55,118,.466,100,227,.441,.529,32,39,.821,12,34,46,109,30,0,49,80,397
1988,Craig Hodges,SG,27,PHO,23,0,462,87,178,.489,31,57,.544,56,121,.463,.576,27,32,.844,7,25,32,44,16,2,28,38,232
1988,Michael Holton,PG,26,POR,82,2,1279,163,353,.462,3,15,.200,160,338,.473,.466,107,129,.829,50,99,149,211,41,10,86,154,436
1988,Dave Hoppen,C,23,TOT,39,8,642,84,183,.459,0,1,.000,84,182,.462,.459,54,62,.871,58,116,174,32,13,6,37,87,222
1988,Dave Hoppen,C,23,MIL,3,0,35,4,11,.364,0,0,,4,11,.364,.364,3,3,1.000,4,3,7,2,0,0,2,3,11
1988,Dave Hoppen,C,23,GSW,36,8,607,80,172,.465,0,1,.000,80,171,.468,.465,51,59,.864,54,113,167,30,13,6,35,84,211
1988,Dennis Hopson,SG,22,NJN,61,19,1365,222,549,.404,12,45,.267,210,504,.417,.415,131,177,.740,63,80,143,118,57,25,119,145,587
1988,Jeff Hornacek,SG,24,PHO,82,49,2243,306,605,.506,17,58,.293,289,547,.528,.520,152,185,.822,71,191,262,540,107,10,156,151,781
1988,Phil Hubbard,SF,31,CLE,78,59,1631,237,485,.489,0,5,.000,237,480,.494,.489,182,243,.749,117,164,281,81,50,7,118,167,656
1988,Eddie Hughes,PG,27,UTA,11,0,42,5,13,.385,1,6,.167,4,7,.571,.423,6,6,1.000,3,1,4,8,0,0,6,5,17
1988,Jay Humphries,PG,25,TOT,68,33,1809,284,538,.528,3,18,.167,281,520,.540,.531,112,153,.732,49,125,174,395,81,5,127,177,683
1988,Jay Humphries,PG,25,PHO,50,33,1557,264,484,.545,3,16,.188,261,468,.558,.549,103,139,.741,44,107,151,354,61,4,108,154,634
1988,Jay Humphries,PG,25,MIL,18,0,252,20,54,.370,0,2,.000,20,52,.385,.370,9,14,.643,5,18,23,41,20,1,19,23,49
1988,Marc Iavaroni,PF,31,UTA,81,71,1238,143,308,.464,0,2,.000,143,306,.467,.464,78,99,.788,94,174,268,67,23,25,83,162,364
1988,Mark Jackson,PG,22,NYK,82,80,3249,438,1013,.432,32,126,.254,406,887,.458,.448,206,266,.774,120,276,396,868,205,6,258,244,1114
1988,Michael Jackson,PG,23,SAC,58,0,760,64,171,.374,6,25,.240,58,146,.397,.392,23,32,.719,17,42,59,179,20,5,58,81,157
1988,Buck Johnson,SF,24,HOU,70,2,879,155,298,.520,1,8,.125,154,290,.531,.522,67,91,.736,77,91,168,49,30,26,54,127,378
1988,Clemon Johnson,C,31,SEA,74,26,723,49,105,.467,0,0,,49,105,.467,.467,22,32,.688,66,108,174,17,13,24,29,104,120
1988,Dennis Johnson*,PG,33,BOS,77,74,2670,352,803,.438,12,46,.261,340,757,.449,.446,255,298,.856,62,178,240,598,93,29,195,204,971
1988,Eddie Johnson,SF,28,PHO,73,59,2177,533,1110,.480,24,94,.255,509,1016,.501,.491,204,240,.850,121,197,318,180,33,9,139,190,1294
1988,Frank Johnson,PG,29,WSB,75,17,1258,216,498,.434,1,9,.111,215,489,.440,.435,121,149,.812,39,82,121,188,70,4,99,120,554
1988,Kannard Johnson,SF,22,CLE,4,0,12,1,3,.333,0,0,,1,3,.333,.333,0,0,,0,0,0,0,1,0,2,1,2
1988,Kevin Johnson,PG,21,TOT,80,28,1917,275,596,.461,5,24,.208,270,572,.472,.466,177,211,.839,36,155,191,437,103,24,146,155,732
1988,Kevin Johnson,PG,21,CLE,52,3,1043,143,311,.460,2,9,.222,141,302,.467,.463,92,112,.821,10,62,72,193,60,17,82,96,380
1988,Kevin Johnson,PG,21,PHO,28,25,874,132,285,.463,3,15,.200,129,270,.478,.468,85,99,.859,26,93,119,244,43,7,64,59,352
1988,Magic Johnson*,PG,28,LAL,72,70,2637,490,996,.492,11,56,.196,479,940,.510,.497,417,489,.853,88,361,449,858,114,13,269,147,1408
1988,Steve Johnson,C,30,POR,43,33,1050,258,488,.529,0,1,.000,258,487,.530,.529,146,249,.586,84,158,242,57,17,32,122,151,662
1988,Vinnie Johnson,SG,31,DET,82,1,1935,425,959,.443,5,24,.208,420,935,.449,.446,147,217,.677,90,141,231,267,58,18,152,164,1002
1988,Caldwell Jones,C,37,POR,79,77,1778,128,263,.487,0,4,.000,128,259,.494,.487,78,106,.736,105,303,408,81,29,99,82,251,334
1988,Charles Jones,PF,30,WSB,69,49,1313,72,177,.407,0,1,.000,72,176,.409,.407,53,75,.707,106,219,325,59,53,113,57,226,197
1988,Charles Jones,PF,26,POR,37,0,186,16,40,.400,0,1,.000,16,39,.410,.400,19,33,.576,11,20,31,8,3,6,12,28,51
1988,Michael Jordan*,SG,24,CHI,82,82,3311,1069,1998,.535,7,53,.132,1062,1945,.546,.537,723,860,.841,139,310,449,485,259,131,252,270,2868
1988,Jerome Kersey,SF,25,POR,79,75,2888,611,1225,.499,3,15,.200,608,1210,.502,.500,291,396,.735,211,446,657,243,127,65,161,302,1516
1988,Albert King,SF,28,PHI,72,44,1593,211,540,.391,17,49,.347,194,491,.395,.406,78,103,.757,71,145,216,109,39,18,93,219,517
1988,Bernard King*,SF,31,WSB,69,38,2044,470,938,.501,1,6,.167,469,932,.503,.502,247,324,.762,86,194,280,192,49,10,211,202,1188
1988,Greg Kite,C,26,TOT,53,19,1063,92,205,.449,0,1,.000,92,204,.451,.449,40,79,.506,85,179,264,47,19,58,73,153,224
1988,Greg Kite,C,26,BOS,13,0,86,9,23,.391,0,0,,9,23,.391,.391,1,6,.167,10,14,24,2,3,8,9,16,19
1988,Greg Kite,C,26,LAC,40,19,977,83,182,.456,0,1,.000,83,181,.459,.456,39,73,.534,75,165,240,45,16,50,64,137,205
1988,Joe Kleine,C,26,SAC,82,60,1999,324,686,.472,0,0,,324,686,.472,.472,153,188,.814,179,400,579,93,28,59,107,228,801
1988,Bart Kofoed,SG,23,UTA,36,0,225,18,48,.375,2,7,.286,16,41,.390,.396,8,13,.615,4,11,15,23,6,1,18,42,46
1988,Jon Koncak,C,24,ATL,49,22,1073,98,203,.483,0,2,.000,98,201,.488,.483,83,136,.610,103,230,333,19,36,56,53,161,279
1988,Larry Krystkowiak,PF,23,MIL,50,7,1050,128,266,.481,0,3,.000,128,263,.487,.481,103,127,.811,88,143,231,50,18,8,57,137,359
1988,Bill Laimbeer,C,30,DET,82,82,2897,455,923,.493,13,39,.333,442,884,.500,.500,187,214,.874,165,667,832,199,66,78,136,284,1110
1988,Jeff Lamp,SF,28,LAL,3,0,7,0,0,,0,0,,0,0,,,2,2,1.000,0,0,0,0,0,0,0,1,2
1988,Allen Leavell,SG,30,HOU,80,54,2150,291,666,.437,19,88,.216,272,578,.471,.451,218,251,.869,22,126,148,405,124,9,130,162,819
1988,Fat Lever,SG,27,DEN,82,82,3061,643,1360,.473,12,57,.211,631,1303,.484,.477,248,316,.785,203,462,665,639,223,21,182,214,1546
1988,Cliff Levingston,PF,27,ATL,82,32,2135,314,564,.557,1,2,.500,313,562,.557,.558,190,246,.772,228,276,504,71,52,84,94,287,819
1988,Ralph Lewis,SG,24,DET,50,0,310,27,87,.310,0,1,.000,27,86,.314,.310,29,48,.604,17,34,51,14,13,4,19,36,83
1988,Reggie Lewis,SG,22,BOS,49,0,405,90,193,.466,0,4,.000,90,189,.476,.466,40,57,.702,28,35,63,26,16,15,30,54,220
1988,Alton Lister,C,29,SEA,82,55,1812,173,343,.504,1,2,.500,172,341,.504,.506,114,188,.606,200,427,627,58,27,140,90,319,461
1988,Brad Lohaus,PF,23,BOS,70,4,718,122,246,.496,3,13,.231,119,233,.511,.502,50,62,.806,46,92,138,49,20,41,59,123,297
1988,John Long,SG,31,IND,81,81,2022,417,879,.474,34,77,.442,383,802,.478,.494,166,183,.907,72,157,229,173,84,11,127,164,1034
1988,John Lucas,PG,34,MIL,81,22,1766,281,631,.445,51,151,.338,230,480,.479,.486,130,162,.802,29,130,159,392,88,3,125,102,743
1988,Maurice Lucas,PF,35,POR,73,0,1191,168,373,.450,0,3,.000,168,370,.454,.450,109,148,.736,101,214,315,94,33,10,73,188,445
1988,Rick Mahorn,PF,29,DET,67,64,1963,276,481,.574,1,2,.500,275,479,.574,.575,164,217,.756,159,406,565,60,43,42,119,262,717
1988,Jeff Malone,SG,26,WSB,80,80,2655,648,1360,.476,10,24,.417,638,1336,.478,.480,335,380,.882,44,162,206,237,51,13,172,198,1641
1988,Karl Malone*,PF,24,UTA,82,82,3198,858,1650,.520,0,5,.000,858,1645,.522,.520,552,789,.700,277,709,986,199,117,50,325,296,2268
1988,Moses Malone*,C,32,WSB,79,78,2692,531,1090,.487,2,7,.286,529,1083,.488,.488,543,689,.788,372,512,884,112,59,72,249,160,1607
1988,Pace Mannion,SF,27,MIL,35,1,477,48,118,.407,2,12,.167,46,106,.434,.415,25,37,.676,17,34,51,55,13,7,24,53,123
1988,Bill Martin,SF,25,PHO,10,0,101,16,51,.314,0,1,.000,16,50,.320,.314,8,13,.615,9,18,27,6,5,0,9,16,40
1988,Maurice Martin,SF,23,DEN,26,0,136,23,61,.377,1,4,.250,22,57,.386,.385,10,21,.476,13,11,24,14,6,3,10,21,57
1988,Wes Matthews,PG,28,LAL,51,8,706,114,248,.460,7,30,.233,107,218,.491,.474,54,65,.831,16,50,66,138,25,3,69,65,289
1988,Cedric Maxwell,SF,32,HOU,71,0,848,80,171,.468,0,2,.000,80,169,.473,.468,110,143,.769,74,105,179,60,22,12,54,75,270
1988,Tim McCormick,C,25,TOT,70,55,2114,348,648,.537,0,2,.000,348,646,.539,.537,145,215,.674,146,321,467,118,32,23,111,234,841
1988,Tim McCormick,C,25,PHI,23,17,601,71,138,.514,0,0,,71,138,.514,.514,37,53,.698,49,95,144,26,14,8,35,75,179
1988,Tim McCormick,C,25,NJN,47,38,1513,277,510,.543,0,2,.000,277,508,.545,.543,108,162,.667,97,226,323,92,18,15,76,159,662
1988,Rodney McCray,SF,26,HOU,81,80,2689,359,746,.481,0,4,.000,359,742,.484,.481,288,367,.785,232,399,631,264,57,51,144,166,1006
1988,Xavier McDaniel,SF,24,SEA,78,77,2703,687,1407,.488,14,50,.280,673,1357,.496,.493,281,393,.715,206,312,518,263,96,52,223,230,1669
1988,Ben McDonald,PF,25,GSW,81,41,2039,258,552,.467,9,35,.257,249,517,.482,.476,87,111,.784,133,202,335,138,39,8,93,246,612
1988,Mike McGee,SF-SG,28,TOT,48,0,1003,223,530,.421,53,160,.331,170,370,.459,.471,76,102,.745,55,73,128,71,52,6,65,81,575
1988,Mike McGee,SG,28,ATL,11,0,117,22,52,.423,5,19,.263,17,33,.515,.471,2,6,.333,4,12,16,13,5,0,7,6,51
1988,Mike McGee,SF,28,SAC,37,0,886,201,478,.421,48,141,.340,153,337,.454,.471,74,96,.771,51,61,112,58,47,6,58,75,524
1988,Kevin McHale*,PF,30,BOS,64,63,2390,550,911,.604,0,0,,550,911,.604,.604,346,434,.797,159,377,536,171,27,92,141,179,1446
1988,Kevin McKenna,SG,29,NJN,31,2,393,43,109,.394,16,50,.320,27,59,.458,.468,24,25,.960,4,27,31,40,15,2,19,55,126
1988,Derrick McKey,SF,21,SEA,82,4,1706,255,519,.491,11,30,.367,244,489,.499,.502,173,224,.772,115,213,328,107,70,63,108,237,694
1988,Nate McMillan,PG,23,SEA,82,82,2453,235,496,.474,9,24,.375,226,472,.479,.483,145,205,.707,117,221,338,702,169,47,189,238,624
1988,Mark McNamara,C,28,PHI,42,18,581,52,133,.391,0,0,,52,133,.391,.391,48,66,.727,66,91,157,18,4,12,26,67,152
1988,Chris McNealy,PF,26,NYK,19,0,265,23,74,.311,0,0,,23,74,.311,.311,21,31,.677,24,40,64,23,16,2,17,50,67
1988,Reggie Miller*,SG,22,IND,82,1,1840,306,627,.488,61,172,.355,245,455,.538,.537,149,186,.801,95,95,190,132,53,19,101,157,822
1988,Dirk Minniefield,PG,27,TOT,72,6,1070,108,221,.489,4,16,.250,104,205,.507,.498,41,55,.745,30,66,96,228,59,3,93,133,261
1988,Dirk Minniefield,PG,27,GSW,11,0,202,25,48,.521,1,5,.200,24,43,.558,.531,14,23,.609,8,13,21,38,15,0,16,26,65
1988,Dirk Minniefield,PG,27,BOS,61,6,868,83,173,.480,3,11,.273,80,162,.494,.488,27,32,.844,22,53,75,190,44,3,77,107,196
1988,Mike Mitchell,SF,32,SAS,68,20,1501,378,784,.482,3,12,.250,375,772,.486,.484,160,194,.825,54,144,198,68,31,13,52,101,919
1988,Paul Mokeski,C,31,MIL,60,0,848,100,210,.476,0,4,.000,100,206,.485,.476,51,72,.708,70,151,221,22,27,27,49,194,251
1988,Sidney Moncrief*,SG,30,MIL,56,51,1428,217,444,.489,5,31,.161,212,413,.513,.494,164,196,.837,58,122,180,204,41,14,86,109,603
1988,Andre Moore,PF-SF,23,TOT,10,0,50,9,27,.333,0,0,,9,27,.333,.333,6,8,.750,6,8,14,6,2,1,4,6,24
1988,Andre Moore,PF,23,DEN,7,0,34,7,24,.292,0,0,,7,24,.292,.292,6,6,1.000,5,7,12,5,2,1,3,4,20
1988,Andre Moore,SF,23,MIL,3,0,16,2,3,.667,0,0,,2,3,.667,.667,0,2,.000,1,1,2,1,0,0,1,2,4
1988,Johnny Moore,PG,29,TOT,5,0,61,4,10,.400,0,1,.000,4,9,.444,.400,0,0,,2,4,6,12,3,0,7,1,8
1988,Johnny Moore,PG,29,SAS,4,0,51,4,9,.444,0,1,.000,4,8,.500,.444,0,0,,1,3,4,11,3,0,4,1,8
1988,Johnny Moore,PG,29,NJN,1,0,10,0,1,.000,0,0,,0,1,.000,.000,0,0,,1,1,2,1,0,0,3,0,0
1988,Ron Moore,C,26,TOT,14,0,59,9,29,.310,0,0,,9,29,.310,.310,6,8,.750,2,6,8,1,5,0,4,21,24
1988,Ron Moore,C,26,DET,9,0,25,4,13,.308,0,0,,4,13,.308,.308,2,4,.500,2,0,2,1,2,0,3,8,10
1988,Ron Moore,C,26,PHO,5,0,34,5,16,.313,0,0,,5,16,.313,.313,4,4,1.000,0,6,6,0,3,0,1,13,14
1988,Chris Mullin*,SF,24,GSW,60,55,2033,470,926,.508,34,97,.351,436,829,.526,.526,239,270,.885,58,147,205,290,113,32,156,136,1213
1988,Jay Murphy,PF,25,WSB,9,0,46,8,23,.348,0,0,,8,23,.348,.348,4,5,.800,4,12,16,1,0,0,5,5,20
1988,Ronnie Murphy,SF,23,POR,18,0,89,14,49,.286,1,4,.250,13,45,.289,.296,7,11,.636,5,6,11,6,5,1,8,14,36
1988,Tod Murphy,PF,24,LAC,1,0,19,1,1,1.000,0,0,,1,1,1.000,1.000,3,4,.750,1,1,2,2,1,0,0,2,5
1988,Pete Myers,SG,24,SAS,22,0,328,43,95,.453,0,4,.000,43,91,.473,.453,26,39,.667,11,26,37,48,17,6,33,30,112
1988,Larry Nance,PF,28,TOT,67,60,2383,487,920,.529,2,6,.333,485,914,.531,.530,304,390,.779,193,414,607,207,63,159,155,242,1280
1988,Larry Nance,PF,28,PHO,40,34,1477,327,616,.531,2,5,.400,325,611,.532,.532,187,249,.751,119,275,394,123,45,96,106,152,843
1988,Larry Nance,PF,28,CLE,27,26,906,160,304,.526,0,1,.000,160,303,.528,.526,117,141,.830,74,139,213,84,18,63,49,90,437
1988,Calvin Natt,PF,31,DEN,27,7,533,102,208,.490,0,1,.000,102,207,.493,.490,54,73,.740,35,61,96,47,13,3,30,43,258
1988,Ed Nealy,PF,27,SAS,68,1,837,50,109,.459,1,2,.500,49,107,.458,.463,41,63,.651,82,140,222,49,29,5,27,94,142
1988,Martin Nessley,C,22,TOT,44,0,336,20,52,.385,0,0,,20,52,.385,.385,8,18,.444,23,59,82,16,8,12,23,89,48
1988,Martin Nessley,C,22,LAC,35,0,295,18,49,.367,0,0,,18,49,.367,.367,7,14,.500,20,53,73,16,7,11,21,78,43
1988,Martin Nessley,C,22,SAC,9,0,41,2,3,.667,0,0,,2,3,.667,.667,1,4,.250,3,6,9,0,1,1,2,11,5
1988,Chuck Nevitt,C,28,DET,17,0,63,7,21,.333,0,0,,7,21,.333,.333,3,6,.500,4,14,18,0,1,5,2,12,17
1988,Johnny Newman,SF,24,NYK,77,25,1589,270,620,.435,26,93,.280,244,527,.463,.456,207,246,.841,87,72,159,62,72,11,103,204,773
1988,Kurt Nimphius,C,29,SAS,72,7,919,128,257,.498,0,1,.000,128,256,.500,.498,60,83,.723,62,91,153,53,22,56,49,141,316
1988,Ken Norman,SF,23,LAC,66,28,1435,241,500,.482,0,10,.000,241,490,.492,.482,87,170,.512,100,163,263,78,44,34,103,123,569
1988,Mike O'Koren,SF,29,NJN,4,0,52,9,16,.563,0,1,.000,9,15,.600,.563,0,4,.000,1,3,4,2,3,2,0,2,18
1988,Charles Oakley,PF,24,CHI,82,82,2816,375,776,.483,3,12,.250,372,764,.487,.485,261,359,.727,326,740,1066,248,68,28,241,272,1014
1988,Hakeem Olajuwon*,C,25,HOU,79,79,2825,712,1385,.514,0,4,.000,712,1381,.516,.514,381,548,.695,302,657,959,163,162,214,243,324,1805
1988,Jawann Oldham,C,30,SAC,54,13,946,119,250,.476,0,0,,119,250,.476,.476,59,87,.678,82,222,304,33,12,110,62,143,297
1988,Louis Orr,SF,29,NYK,29,0,180,16,50,.320,0,1,.000,16,49,.327,.320,8,16,.500,13,21,34,9,6,0,14,27,40
1988,Robert Parish*,C,34,BOS,74,73,2312,442,750,.589,0,1,.000,442,749,.590,.589,177,241,.734,173,455,628,115,55,84,154,198,1061
1988,Jim Paxson,SG,30,TOT,45,3,801,137,298,.460,5,21,.238,132,277,.477,.468,68,79,.861,15,30,45,76,30,5,39,73,347
1988,Jim Paxson,SG,30,POR,17,1,263,43,107,.402,3,8,.375,40,99,.404,.416,14,18,.778,8,10,18,27,7,1,11,29,103
1988,Jim Paxson,SG,30,BOS,28,2,538,94,191,.492,2,13,.154,92,178,.517,.497,54,61,.885,7,20,27,49,23,4,28,44,244
1988,John Paxson,PG,27,CHI,81,30,1888,287,582,.493,33,95,.347,254,487,.522,.521,33,45,.733,16,88,104,303,49,1,64,154,640
1988,Sam Perkins,PF,26,DAL,75,75,2499,394,876,.450,5,30,.167,389,846,.460,.453,273,332,.822,201,400,601,118,74,54,119,227,1066
1988,Chuck Person,SF,23,IND,79,71,2807,575,1252,.459,59,177,.333,516,1075,.480,.483,132,197,.670,171,365,536,309,73,8,210,266,1341
1988,Jim Petersen,PF,25,HOU,69,50,1793,249,488,.510,1,6,.167,248,482,.515,.511,114,153,.745,145,291,436,106,36,40,119,203,613
1988,Michael Phelps,SG,26,LAC,2,0,23,3,7,.429,0,0,,3,7,.429,.429,3,4,.750,0,2,2,3,5,0,2,1,9
1988,Ricky Pierce,SG,28,MIL,37,0,965,248,486,.510,3,14,.214,245,472,.519,.513,107,122,.877,30,53,83,73,21,7,57,94,606
1988,Ed Pinckney,PF,24,SAC,79,7,1177,179,343,.522,0,2,.000,179,341,.525,.522,133,178,.747,94,136,230,66,39,32,77,118,491
1988,Scottie Pippen*,SF,22,CHI,79,0,1650,261,564,.463,4,23,.174,257,541,.475,.466,99,172,.576,115,183,298,169,91,52,131,214,625
1988,Olden Polynice,C,23,SEA,82,0,1080,118,254,.465,0,2,.000,118,252,.468,.465,101,158,.639,122,208,330,33,32,26,81,215,337
1988,Terry Porter,PG,24,POR,82,82,2991,462,890,.519,24,69,.348,438,821,.533,.533,274,324,.846,65,313,378,831,150,16,244,204,1222
1988,Paul Pressey,SG,29,MIL,75,75,2484,345,702,.491,8,39,.205,337,663,.508,.497,285,357,.798,130,245,375,523,112,34,198,233,983
1988,Harold Pressley,SF,24,SAC,80,49,2029,318,702,.453,36,110,.327,282,592,.476,.479,103,130,.792,139,230,369,185,84,55,135,211,775
1988,Mark Price,PG,23,CLE,80,79,2626,493,974,.506,72,148,.486,421,826,.510,.543,221,252,.877,54,126,180,480,99,12,184,119,1279
1988,Kurt Rambis,PF,29,LAL,70,20,845,102,186,.548,0,0,,102,186,.548,.548,73,93,.785,103,165,268,54,39,13,59,103,277
1988,Blair Rasmussen,C,25,DEN,79,45,1779,435,884,.492,0,0,,435,884,.492,.492,132,170,.776,130,307,437,78,22,81,73,241,1002
1988,Robert Reid,SG,32,HOU,62,31,980,165,356,.463,13,34,.382,152,322,.472,.482,50,63,.794,38,87,125,67,27,5,41,118,393
1988,Richard Rellford,SF,23,SAS,4,0,42,5,8,.625,0,0,,5,8,.625,.625,6,8,.750,2,5,7,1,0,3,4,3,16
1988,Jerry Reynolds,SF,25,MIL,62,21,1161,188,419,.449,3,7,.429,185,412,.449,.452,119,154,.773,70,90,160,104,74,32,104,97,498
1988,Doc Rivers,PG,26,ATL,80,80,2502,403,890,.453,9,33,.273,394,857,.460,.458,319,421,.758,83,283,366,747,140,41,210,272,1134
1988,Fred Roberts,PF,27,BOS,74,14,1032,161,330,.488,0,6,.000,161,324,.497,.488,128,165,.776,60,102,162,81,16,15,68,118,450
1988,Alvin Robertson,SG,25,SAS,82,82,2978,655,1408,.465,27,95,.284,628,1313,.478,.475,273,365,.748,165,333,498,557,243,69,251,300,1610
1988,Cliff Robinson,SF,27,PHI,62,51,2110,483,1041,.464,2,9,.222,481,1032,.466,.465,210,293,.717,116,289,405,131,79,39,161,192,1178
1988,Dennis Rodman*,SF,26,DET,82,32,2147,398,709,.561,5,17,.294,393,692,.568,.565,152,284,.535,318,397,715,110,75,45,156,273,953
1988,Johnny Rogers,PF,24,CLE,24,0,168,26,61,.426,0,2,.000,26,59,.441,.426,10,13,.769,8,19,27,3,4,3,10,23,62
1988,Tree Rollins,C,32,ATL,76,59,1765,133,260,.512,0,0,,133,260,.512,.512,70,80,.875,142,317,459,20,31,132,51,229,336
1988,Scott Roth,SF,24,UTA,26,0,201,30,74,.405,2,11,.182,28,63,.444,.419,22,30,.733,7,21,28,16,12,0,11,37,84
1988,Brian Rowsom,PF,22,IND,4,0,16,0,6,.000,0,0,,0,6,.000,.000,6,6,1.000,1,4,5,1,1,0,1,3,6
1988,Walker Russell,PG,27,DET,1,0,1,0,1,.000,0,1,.000,0,0,,.000,0,0,,0,0,0,1,0,0,0,0,0
1988,John Salley,C,23,DET,82,16,2003,258,456,.566,0,0,,258,456,.566,.566,185,261,.709,166,236,402,113,53,137,120,294,701
1988,Ralph Sampson*,C-PF,27,TOT,48,44,1663,299,682,.438,2,11,.182,297,671,.443,.440,149,196,.760,140,322,462,122,41,88,171,164,749
1988,Ralph Sampson*,PF,27,HOU,19,19,705,119,271,.439,2,6,.333,117,265,.442,.443,63,85,.741,58,114,172,37,17,33,62,63,303
1988,Ralph Sampson*,C,27,GSW,29,25,958,180,411,.438,0,5,.000,180,406,.443,.438,86,111,.775,82,208,290,85,24,55,109,101,446
1988,Mike Sanders,SF,27,TOT,59,16,883,153,303,.505,0,1,.000,153,302,.507,.505,59,76,.776,38,71,109,56,31,9,50,131,365
1988,Mike Sanders,SF,27,PHO,35,5,466,82,171,.480,0,1,.000,82,170,.482,.480,39,53,.736,28,34,62,30,18,4,27,73,203
1988,Mike Sanders,SF,27,CLE,24,11,417,71,132,.538,0,0,,71,132,.538,.538,20,23,.870,10,37,47,26,13,5,23,58,162
1988,Danny Schayes,PF,28,DEN,81,74,2166,361,668,.540,0,2,.000,361,666,.542,.540,407,487,.836,200,462,662,106,62,92,155,323,1129
1988,Russ Schoene,PF,27,SEA,81,2,973,208,454,.458,17,58,.293,191,396,.482,.477,51,63,.810,78,120,198,53,39,13,57,151,484
1988,Detlef Schrempf,SF,25,DAL,82,4,1587,246,539,.456,5,32,.156,241,507,.475,.461,201,266,.756,102,177,279,159,42,32,108,189,698
1988,Byron Scott,SG,26,LAL,81,81,3048,710,1348,.527,62,179,.346,648,1169,.554,.550,272,317,.858,76,257,333,335,155,27,161,204,1754
1988,Carey Scurry,SF,25,TOT,33,0,455,55,118,.466,3,8,.375,52,110,.473,.479,27,39,.692,30,54,84,50,49,23,43,81,140
1988,Carey Scurry,SF,25,UTA,29,0,447,54,116,.466,3,8,.375,51,108,.472,.478,27,39,.692,29,52,81,49,47,22,41,78,138
1988,Carey Scurry,SF,25,NYK,4,0,8,1,2,.500,0,0,,1,2,.500,.500,0,0,,1,2,3,1,2,1,2,3,2
1988,Brad Sellers,SF,25,CHI,82,76,2212,326,714,.457,1,7,.143,325,707,.460,.457,124,157,.790,107,143,250,141,34,66,91,174,777
1988,Purvis Short,SG,30,HOU,81,11,1949,474,986,.481,5,21,.238,469,965,.486,.483,206,240,.858,71,151,222,162,58,14,118,197,1159
1988,Jerry Sichting,PG,31,TOT,52,1,694,93,172,.541,10,22,.455,83,150,.553,.570,17,23,.739,9,27,36,93,21,0,22,60,213
1988,Jerry Sichting,PG,31,BOS,24,1,370,44,82,.537,2,8,.250,42,74,.568,.549,8,12,.667,5,16,21,60,14,0,14,30,98
1988,Jerry Sichting,PG,31,POR,28,0,324,49,90,.544,8,14,.571,41,76,.539,.589,9,11,.818,4,11,15,33,7,0,8,30,115
1988,Jack Sikma*,PF,32,MIL,82,82,2923,514,1058,.486,3,14,.214,511,1044,.489,.487,321,348,.922,195,514,709,279,93,80,157,316,1352
1988,Scott Skiles,PG,23,IND,51,2,760,86,209,.411,6,20,.300,80,189,.423,.426,45,54,.833,11,55,66,180,22,3,76,97,223
1988,Derek Smith,SG,26,SAC,35,18,899,174,364,.478,8,23,.348,166,341,.487,.489,87,113,.770,35,68,103,89,21,17,48,108,443
1988,Kenny Smith,PG,22,SAC,61,60,2170,331,694,.477,12,39,.308,319,655,.487,.486,167,204,.819,40,98,138,434,92,8,184,140,841
1988,Larry Smith,PF,30,GSW,20,10,499,58,123,.472,0,1,.000,58,122,.475,.472,11,27,.407,79,103,182,25,12,11,36,63,127
1988,Otis Smith,SG,24,TOT,72,18,1549,325,662,.491,13,41,.317,312,621,.502,.501,178,229,.777,126,121,247,155,91,42,107,160,841
1988,Otis Smith,SG,24,DEN,15,6,191,37,93,.398,0,0,,37,93,.398,.398,21,28,.750,16,14,30,11,5,6,12,23,95
1988,Otis Smith,SG,24,GSW,57,12,1358,288,569,.506,13,41,.317,275,528,.521,.518,157,201,.781,110,107,217,144,86,36,95,137,746
1988,Mike Smrek,C,25,LAL,48,2,421,44,103,.427,0,0,,44,103,.427,.427,44,66,.667,27,58,85,8,7,42,30,105,132
1988,Rory Sparrow,PG,29,TOT,58,25,1044,117,293,.399,2,13,.154,115,280,.411,.403,24,33,.727,15,57,72,167,41,3,58,79,260
1988,Rory Sparrow,PG,29,NYK,3,0,52,5,19,.263,0,1,.000,5,18,.278,.263,0,0,,1,1,2,5,4,0,6,7,10
1988,Rory Sparrow,PG,29,CHI,55,25,992,112,274,.409,2,12,.167,110,262,.420,.412,24,33,.727,14,56,70,162,37,3,52,72,250
1988,Steve Stipanovich,C,27,IND,80,80,2692,411,828,.496,3,15,.200,408,813,.502,.498,254,314,.809,157,505,662,183,90,69,156,302,1079
1988,John Stockton*,PG,25,UTA,82,79,2842,454,791,.574,24,67,.358,430,724,.594,.589,272,324,.840,54,183,237,1128,242,16,262,247,1204
1988,John Stroeder,PF,29,MIL,41,0,271,29,79,.367,0,2,.000,29,77,.377,.367,20,30,.667,24,47,71,20,3,12,24,48,78
1988,Jon Sundvold,PG,26,SAS,52,12,1024,176,379,.464,26,64,.406,150,315,.476,.499,43,48,.896,14,34,48,183,27,2,57,54,421
1988,Roy Tarpley,PF,23,DAL,81,9,2307,444,888,.500,0,5,.000,444,883,.503,.500,205,277,.740,360,599,959,86,103,86,172,313,1093
1988,Terry Teagle,SG,27,GSW,47,4,958,248,546,.454,1,9,.111,247,537,.460,.455,97,121,.802,41,40,81,61,32,4,80,95,594
1988,Reggie Theus,SG,30,SAC,73,73,2653,619,1318,.470,16,59,.271,603,1259,.479,.476,320,385,.831,72,160,232,463,59,16,234,173,1574
1988,Isiah Thomas*,PG,26,DET,81,81,2927,621,1341,.463,30,97,.309,591,1244,.475,.474,305,394,.774,64,214,278,678,141,17,273,217,1577
1988,Bernard Thompson,SF,25,PHO,37,7,566,74,159,.465,0,2,.000,74,157,.471,.465,43,60,.717,40,36,76,51,21,1,21,75,191
1988,Billy Thompson,SF,24,LAL,9,0,38,3,13,.231,0,0,,3,13,.231,.231,8,10,.800,2,7,9,1,1,0,6,11,14
1988,LaSalle Thompson,C,26,SAC,69,9,1257,215,456,.471,2,5,.400,213,451,.472,.474,118,164,.720,138,289,427,68,54,73,109,217,550
1988,Mychal Thompson,C,33,LAL,80,0,2007,370,722,.512,0,3,.000,370,719,.515,.512,185,292,.634,198,291,489,66,38,79,113,251,925
1988,Bob Thornton,PF,25,TOT,48,2,593,65,130,.500,0,2,.000,65,128,.508,.500,34,55,.618,46,66,112,15,11,3,35,103,164
1988,Bob Thornton,PF,25,NYK,7,0,85,6,19,.316,0,0,,6,19,.316,.316,5,8,.625,5,8,13,4,2,0,8,23,17
1988,Bob Thornton,PF,25,PHI,41,2,508,59,111,.532,0,2,.000,59,109,.541,.532,29,47,.617,41,58,99,11,9,3,27,80,147
1988,Otis Thorpe,PF,25,SAC,82,82,3072,622,1226,.507,0,6,.000,622,1220,.510,.507,460,609,.755,279,558,837,266,62,56,228,264,1704
1988,Sedale Threatt,PG,26,TOT,71,0,1055,216,425,.508,3,27,.111,213,398,.535,.512,57,71,.803,23,65,88,160,60,8,63,100,492
1988,Sedale Threatt,PG,26,CHI,45,0,701,132,263,.502,2,20,.100,130,243,.535,.506,32,41,.780,12,43,55,107,27,3,44,71,298
1988,Sedale Threatt,PG,26,SEA,26,0,354,84,162,.519,1,7,.143,83,155,.535,.522,25,30,.833,11,22,33,53,33,5,19,29,194
1988,Wayman Tisdale,PF,23,IND,79,57,2378,511,998,.512,0,2,.000,511,996,.513,.512,246,314,.783,168,323,491,103,54,34,145,274,1268
1988,Ray Tolbert,PF,29,TOT,25,0,259,35,69,.507,0,0,,35,69,.507,.507,19,30,.633,23,32,55,10,8,5,21,39,89
1988,Ray Tolbert,PF,29,NYK,11,0,177,19,41,.463,0,0,,19,41,.463,.463,9,17,.529,14,21,35,5,5,2,10,25,47
1988,Ray Tolbert,PF,29,LAL,14,0,82,16,28,.571,0,0,,16,28,.571,.571,10,13,.769,9,11,20,5,3,3,11,14,42
1988,Andrew Toney,SG,30,PHI,29,15,522,72,171,.421,9,27,.333,63,144,.438,.447,58,72,.806,8,39,47,108,11,6,50,35,211
1988,Sedric Toney,PG,25,NYK,21,0,139,21,48,.438,5,14,.357,16,34,.471,.490,10,11,.909,3,5,8,24,9,1,12,20,57
1988,Kelly Tripucka,SF,28,UTA,49,21,976,139,303,.459,31,74,.419,108,229,.472,.510,59,68,.868,30,87,117,105,34,4,68,68,368
1988,Trent Tucker,SG,28,NYK,71,4,1248,193,455,.424,69,167,.413,124,288,.431,.500,51,71,.718,32,87,119,117,53,6,47,158,506
1988,Andre Turner,PG,23,HOU,12,0,99,12,34,.353,1,7,.143,11,27,.407,.368,10,14,.714,4,4,8,23,7,1,12,13,35
1988,Elston Turner,SF,28,CHI,17,0,98,8,30,.267,0,0,,8,30,.267,.267,1,2,.500,8,2,10,9,8,0,10,5,17
1988,Melvin Turpin,C,27,UTA,79,0,1011,199,389,.512,1,3,.333,198,386,.513,.513,71,98,.724,88,148,236,32,26,68,71,157,470
1988,Terry Tyler,SF,31,SAC,74,28,1185,184,407,.452,1,7,.143,183,400,.458,.453,41,64,.641,87,155,242,56,43,47,43,85,410
1988,Darnell Valentine,PG,28,LAC,79,31,1636,223,533,.418,15,33,.455,208,500,.416,.432,101,136,.743,37,119,156,382,122,8,148,135,562
1988,Kiki Vandeweghe,SF,29,POR,37,7,1038,283,557,.508,22,58,.379,261,499,.523,.528,159,181,.878,36,73,109,71,21,7,48,68,747
1988,Jay Vincent,SF,28,DEN,73,8,1755,446,958,.466,1,4,.250,445,954,.466,.466,231,287,.805,80,229,309,143,46,26,137,198,1124
1988,Sam Vincent,PG,24,TOT,72,27,1501,210,461,.456,8,21,.381,202,440,.459,.464,145,167,.868,35,117,152,381,55,16,136,145,573
1988,Sam Vincent,PG,24,SEA,43,0,548,72,152,.474,5,13,.385,67,139,.482,.490,46,60,.767,17,32,49,137,21,4,52,63,195
1988,Sam Vincent,PG,24,CHI,29,27,953,138,309,.447,3,8,.375,135,301,.449,.451,99,107,.925,18,85,103,244,34,12,84,82,378
1988,Danny Vranes,SF,29,PHI,57,5,772,53,121,.438,0,3,.000,53,118,.449,.438,15,35,.429,45,72,117,36,27,33,25,100,121
1988,Mark Wade,PG,22,GSW,11,0,123,3,20,.150,0,2,.000,3,18,.167,.150,2,4,.500,3,12,15,34,7,1,13,13,8
1988,Milt Wagner,SG,24,LAL,40,4,380,62,147,.422,2,10,.200,60,137,.438,.429,26,29,.897,4,24,28,61,6,4,22,42,152
1988,Granville Waiters,C,27,CHI,22,0,114,9,29,.310,0,1,.000,9,28,.321,.310,0,2,.000,9,19,28,1,2,15,6,26,18
1988,Darrell Walker,SG,26,WSB,52,0,940,114,291,.392,0,6,.000,114,285,.400,.392,82,105,.781,43,84,127,100,62,10,69,105,310
1988,Kenny Walker,SF,23,NYK,82,61,2139,344,728,.473,0,1,.000,344,727,.473,.473,138,178,.775,192,197,389,86,63,59,83,290,826
1988,Jamie Waller,SG,23,NJN,9,0,91,16,40,.400,0,2,.000,16,38,.421,.400,10,18,.556,9,4,13,3,4,1,11,13,42
1988,Chris Washburn,C,22,TOT,37,0,260,36,81,.444,0,0,,36,81,.444,.444,18,31,.581,28,47,75,6,5,8,17,29,90
1988,Chris Washburn,C,22,GSW,8,0,86,14,32,.438,0,0,,14,32,.438,.438,5,8,.625,9,11,20,3,1,0,7,10,33
1988,Chris Washburn,C,22,ATL,29,0,174,22,49,.449,0,0,,22,49,.449,.449,13,23,.565,19,36,55,3,4,8,10,19,57
1988,Duane Washington,SG,23,NJN,15,0,156,18,42,.429,2,4,.500,16,38,.421,.452,16,20,.800,5,17,22,34,12,0,9,23,54
1988,Kermit Washington,PF,36,GSW,6,1,56,7,14,.500,0,0,,7,14,.500,.500,2,2,1.000,9,10,19,0,4,4,4,13,16
1988,Pearl Washington,PG,24,NJN,68,10,1379,245,547,.448,11,49,.224,234,498,.470,.458,132,189,.698,54,64,118,206,91,4,141,163,633
1988,Spud Webb,PG,24,ATL,82,1,1347,191,402,.475,1,19,.053,190,383,.496,.476,107,131,.817,16,130,146,337,63,12,131,125,490
1988,Chris Welp,C,24,PHI,10,0,132,18,31,.581,0,0,,18,31,.581,.581,12,18,.667,11,13,24,5,5,5,9,25,48
1988,Bill Wennington,C,24,DAL,30,0,125,25,49,.510,1,2,.500,24,47,.511,.520,12,19,.632,14,25,39,4,5,9,9,33,63
1988,Mark West,C,27,TOT,83,41,2098,316,573,.551,0,1,.000,316,572,.552,.551,170,285,.596,165,358,523,74,47,147,173,265,802
1988,Mark West,C,27,CLE,54,12,1183,182,316,.576,0,0,,182,316,.576,.576,95,153,.621,83,198,281,50,25,79,91,158,459
1988,Mark West,C,27,PHO,29,29,915,134,257,.521,0,1,.000,134,256,.523,.521,75,132,.568,82,160,242,24,22,68,82,107,343
1988,Ennis Whatley,PG,25,ATL,5,0,24,4,9,.444,0,0,,4,9,.444,.444,3,4,.750,0,4,4,2,2,0,4,3,11
1988,Clinton Wheeler,PG,28,IND,59,0,513,62,132,.470,0,0,,62,132,.470,.470,25,34,.735,19,21,40,103,36,2,52,37,149
1988,Eric White,SF,22,LAC,17,4,352,66,124,.532,1,1,1.000,65,123,.528,.536,45,57,.789,31,31,62,9,7,3,21,32,178
1988,Tony White,PG,22,TOT,49,0,581,111,249,.446,0,6,.000,111,243,.457,.446,39,54,.722,12,19,31,59,20,2,47,57,261
1988,Tony White,PG,22,CHI,2,0,2,0,0,,0,0,,0,0,,,0,0,,0,0,0,0,0,0,0,0,0
1988,Tony White,PG,22,NYK,12,0,117,17,46,.370,0,1,.000,17,45,.378,.370,9,13,.692,1,2,3,10,1,0,13,14,43
1988,Tony White,PG,22,GSW,35,0,462,94,203,.463,0,5,.000,94,198,.475,.463,30,41,.732,11,17,28,49,19,2,34,43,218
1988,Jerome Whitehead,C,31,GSW,72,27,1221,174,360,.483,0,0,,174,360,.483,.483,59,82,.720,109,212,321,39,32,21,49,209,407
1988,Dominique Wilkins*,SF,28,ATL,78,76,2948,909,1957,.464,38,129,.295,871,1828,.476,.474,541,655,.826,211,291,502,224,103,47,218,162,2397
1988,Gerald Wilkins,SG,24,NYK,81,78,2703,591,1324,.446,39,129,.302,552,1195,.462,.461,191,243,.786,106,164,270,326,90,22,212,183,1412
1988,Buck Williams,PF,27,NJN,70,70,2637,466,832,.560,1,1,1.000,465,831,.560,.561,346,518,.668,298,536,834,109,68,44,189,266,1279
1988,Herb Williams,C,29,IND,75,37,1966,311,732,.425,0,6,.000,311,726,.428,.425,126,171,.737,116,353,469,98,37,146,119,244,748
1988,Hot Rod Williams,PF,25,CLE,77,50,2106,316,663,.477,0,1,.000,316,662,.477,.477,211,279,.756,159,347,506,103,61,145,104,203,843
1988,John Williams,SF,21,WSB,82,37,2428,427,910,.469,5,38,.132,422,872,.484,.472,188,256,.734,127,317,444,232,117,34,145,217,1047
1988,Kevin Williams,SG,26,SEA,80,9,1084,199,450,.442,1,7,.143,198,443,.447,.443,103,122,.844,61,66,127,96,62,7,68,207,502
1988,Reggie Williams,SF,23,LAC,35,14,857,152,427,.356,13,58,.224,139,369,.377,.371,48,66,.727,55,63,118,58,29,21,63,108,365
1988,Kevin Willis,PF,25,ATL,75,55,2091,356,687,.518,0,2,.000,356,685,.520,.518,159,245,.649,235,312,547,28,68,41,138,240,871
1988,Nikita Wilson,SF,23,POR,15,0,54,7,23,.304,0,0,,7,23,.304,.304,5,6,.833,2,9,11,3,0,0,5,7,19
1988,Ricky Wilson,PG,23,TOT,24,1,420,43,110,.391,10,26,.385,33,84,.393,.436,29,40,.725,2,25,27,69,23,3,25,40,125
1988,Ricky Wilson,PG,23,NJN,6,0,47,7,11,.636,1,1,1.000,6,10,.600,.682,6,11,.545,1,0,1,6,6,0,4,6,21
1988,Ricky Wilson,PG,23,SAS,18,1,373,36,99,.364,9,25,.360,27,74,.365,.409,23,29,.793,1,25,26,63,17,3,21,34,104
1988,David Wingate,SG,24,PHI,61,22,1419,218,545,.400,10,40,.250,208,505,.412,.409,99,132,.750,44,57,101,119,47,22,104,125,545
1988,Rickie Winslow,SF,23,MIL,7,0,45,3,13,.231,0,1,.000,3,12,.250,.231,1,2,.500,3,4,7,2,1,0,4,9,7
1988,Randy Wittman,SG,28,ATL,82,82,2412,376,787,.478,0,0,,376,787,.478,.478,71,89,.798,39,131,170,302,50,18,82,117,823
1988,Joe Wolf,C,23,LAC,42,26,1137,136,334,.407,3,15,.200,133,319,.417,.412,45,54,.833,51,136,187,98,38,16,76,139,320
1988,Leon Wood,PG,25,TOT,52,8,909,136,312,.436,52,127,.409,84,185,.454,.519,76,99,.768,17,40,57,174,26,1,39,50,400
1988,Leon Wood,PG,25,SAS,38,8,830,120,282,.426,43,108,.398,77,174,.443,.502,69,91,.758,16,35,51,155,22,1,34,44,352
1988,Leon Wood,PG,25,ATL,14,0,79,16,30,.533,9,19,.474,7,11,.636,.683,7,8,.875,1,5,6,19,4,0,5,6,48
1988,Mike Woodson,SG,29,LAC,80,77,2534,562,1263,.445,18,78,.231,544,1185,.459,.452,296,341,.868,64,126,190,273,109,26,186,210,1438
1988,Orlando Woolridge,SF,28,NJN,19,12,622,110,247,.445,0,2,.000,110,245,.449,.445,92,130,.708,31,60,91,71,13,20,48,73,312
1988,James Worthy*,SF,26,LAL,75,72,2655,617,1161,.531,2,16,.125,615,1145,.537,.532,242,304,.796,129,245,374,289,72,55,155,175,1478
1988,Brad Wright,PF,25,DEN,2,0,7,1,5,.200,0,0,,1,5,.200,.200,0,0,,0,1,1,0,0,0,2,3,2
1988,Danny Young,PG,25,SEA,77,0,949,89,218,.408,22,77,.286,67,141,.475,.459,43,53,.811,18,57,75,218,52,2,37,69,243
1988,Phil Zevenbergen,C,23,SAS,8,0,58,15,27,.556,0,0,,15,27,.556,.556,0,2,.000,4,9,13,3,3,1,4,12,30
1989,Kareem Abdul-Jabbar*,C,41,LAL,74,74,1695,313,659,.475,0,3,.000,313,656,.477,.475,122,165,.739,103,231,334,74,38,85,95,196,748
1989,Mark Acres,C,26,BOS,62,0,632,55,114,.482,1,1,1.000,54,113,.478,.487,26,48,.542,59,87,146,19,19,6,23,94,137
1989,Michael Adams,PG,26,DEN,77,77,2787,468,1082,.433,166,466,.356,302,616,.490,.509,322,393,.819,71,212,283,490,166,11,180,149,1424
1989,Mark Aguirre,SF,29,TOT,80,76,2597,586,1270,.461,51,174,.293,535,1096,.488,.481,288,393,.733,146,240,386,278,45,36,208,229,1511
1989,Mark Aguirre,SF,29,DAL,44,44,1529,373,829,.450,29,99,.293,344,730,.471,.467,178,244,.730,90,145,235,189,29,29,140,128,953
1989,Mark Aguirre,SF,29,DET,36,32,1068,213,441,.483,22,75,.293,191,366,.522,.508,110,149,.738,56,95,151,89,16,7,68,101,558
1989,Danny Ainge,PG,29,TOT,73,54,2377,480,1051,.457,116,305,.380,364,746,.488,.512,205,240,.854,71,184,255,402,93,8,145,186,1281
1989,Danny Ainge,PG,29,BOS,45,28,1349,271,589,.460,58,155,.374,213,434,.491,.509,114,128,.891,37,117,154,215,52,1,82,108,714
1989,Danny Ainge,PG,29,SAC,28,26,1028,209,462,.452,58,150,.387,151,312,.484,.515,91,112,.813,34,67,101,187,41,7,63,78,567
1989,Mark Alarie,PF,25,WSB,74,5,1141,206,431,.478,13,38,.342,193,393,.491,.493,73,87,.839,103,152,255,63,25,22,62,160,498
1989,Steve Alford,PG,24,TOT,66,3,906,148,324,.457,20,55,.364,128,269,.476,.488,50,61,.820,10,62,72,92,45,3,45,57,366
1989,Steve Alford,PG,24,DAL,9,0,38,3,11,.273,0,2,.000,3,9,.333,.273,1,2,.500,0,3,3,9,1,0,1,3,7
1989,Steve Alford,PG,24,GSW,57,3,868,145,313,.463,20,53,.377,125,260,.481,.495,49,59,.831,10,59,69,83,44,3,44,54,359
1989,Randy Allen,SG,24,SAC,7,0,43,8,19,.421,0,1,.000,8,18,.444,.421,1,2,.500,3,4,7,0,1,1,2,7,17
1989,Greg Anderson,PF,24,SAS,82,56,2401,460,914,.503,0,3,.000,460,911,.505,.503,207,403,.514,255,421,676,61,102,103,180,221,1127
1989,Michael Anderson,PG,22,SAS,36,12,730,73,175,.417,1,7,.143,72,168,.429,.420,57,82,.695,44,45,89,153,44,3,84,64,204
1989,Richard Anderson,PF,28,POR,72,3,1082,145,348,.417,49,141,.348,96,207,.464,.487,32,38,.842,62,169,231,98,44,12,54,100,371
1989,Ron Anderson,SF,30,PHI,82,12,2618,566,1152,.491,2,11,.182,564,1141,.494,.492,196,229,.856,167,239,406,139,71,23,126,166,1330
1989,Willie Anderson,SF,22,SAS,81,79,2738,640,1285,.498,4,21,.190,636,1264,.503,.500,224,289,.775,152,265,417,372,150,62,261,295,1508
1989,John Bagley,PG,28,NJN,68,20,1642,200,481,.416,11,54,.204,189,427,.443,.427,89,123,.724,36,108,144,391,72,5,159,117,500
1989,Thurl Bailey,SF,27,UTA,82,3,2777,615,1272,.483,2,5,.400,613,1267,.484,.484,363,440,.825,115,332,447,138,48,91,208,185,1595
1989,Greg Ballard,SF,34,SEA,2,0,15,1,8,.125,0,1,.000,1,7,.143,.125,4,4,1.000,2,5,7,0,0,0,0,3,6
1989,Ken Bannister,PF,28,LAC,9,2,130,22,36,.611,0,1,.000,22,35,.629,.611,30,53,.566,6,27,33,3,7,2,8,17,74
1989,Charles Barkley*,PF,25,PHI,79,79,3088,700,1208,.579,35,162,.216,665,1046,.636,.594,602,799,.753,403,583,986,325,126,67,254,262,2037
1989,John Battle,SG,26,ATL,82,0,1672,287,628,.457,11,34,.324,276,594,.465,.466,194,238,.815,30,110,140,197,42,9,104,125,779
1989,Benoit Benjamin,C,24,LAC,79,62,2585,491,907,.541,0,2,.000,491,905,.543,.541,317,426,.744,164,532,696,157,57,221,237,221,1299
1989,Ricky Berry,SG,24,SAC,64,21,1406,255,567,.450,65,160,.406,190,407,.467,.507,131,166,.789,57,140,197,80,37,22,82,197,706
1989,Walter Berry,PF,24,TOT,69,31,1355,254,501,.507,1,2,.500,253,499,.507,.508,100,143,.699,86,181,267,77,29,48,89,183,609
1989,Walter Berry,PF,24,NJN,29,17,556,108,231,.468,0,0,,108,231,.468,.468,43,63,.683,32,83,115,20,10,13,40,69,259
1989,Walter Berry,PF,24,HOU,40,14,799,146,270,.541,1,2,.500,145,268,.541,.543,57,80,.713,54,98,152,57,19,35,49,114,350
1989,Larry Bird*,SF,32,BOS,6,6,189,49,104,.471,0,0,,49,104,.471,.471,18,19,.947,1,36,37,29,6,5,11,18,116
1989,Otis Birdsong,SG,33,BOS,13,0,108,18,36,.500,1,3,.333,17,33,.515,.514,0,2,.000,4,9,13,9,3,1,12,10,37
1989,Uwe Blab,C,26,DAL,37,0,208,24,52,.462,0,0,,24,52,.462,.462,20,25,.800,11,33,44,12,3,13,14,36,68
1989,Rolando Blackman,SG,29,DAL,78,78,2946,594,1249,.476,30,85,.353,564,1164,.485,.488,316,370,.854,70,203,273,288,65,20,165,137,1534
1989,Muggsy Bogues,PG,24,CHH,79,21,1755,178,418,.426,1,13,.077,177,405,.437,.427,66,88,.750,53,112,165,620,111,7,124,141,423
1989,Manute Bol,C,26,GSW,80,4,1769,127,344,.369,20,91,.220,107,253,.423,.398,40,66,.606,116,346,462,27,11,345,79,226,314
1989,Anthony Bowie,SG,25,SAS,18,5,438,72,144,.500,1,5,.200,71,139,.511,.503,10,15,.667,25,31,56,29,18,4,22,43,155
1989,Sam Bowie,C,27,POR,20,0,412,69,153,.451,5,7,.714,64,146,.438,.467,28,49,.571,36,70,106,36,7,33,33,43,171
1989,Dudley Bradley,SG,31,ATL,38,0,267,28,86,.326,8,31,.258,20,55,.364,.372,8,16,.500,7,25,32,24,16,2,14,41,72
1989,Adrian Branch,SF,25,POR,67,4,811,202,436,.463,7,31,.226,195,405,.481,.471,87,120,.725,63,69,132,60,45,3,64,99,498
1989,Randy Breuer,C,28,MIL,48,4,513,86,179,.480,0,0,,86,179,.480,.480,28,51,.549,51,84,135,22,9,37,29,59,200
1989,Frank Brickowski,C,29,SAS,64,60,1822,337,654,.515,0,2,.000,337,652,.517,.515,201,281,.715,148,258,406,131,102,35,165,252,875
1989,Scott Brooks,PG,23,PHI,82,6,1372,156,371,.420,55,153,.359,101,218,.463,.495,61,69,.884,19,75,94,306,69,3,65,116,428
1989,Mike Brown,C,25,UTA,66,16,1051,104,248,.419,0,0,,104,248,.419,.419,92,130,.708,92,166,258,41,25,17,77,133,300
1989,Tony Brown,SF-SG,28,TOT,43,0,365,50,118,.424,4,16,.250,46,102,.451,.441,24,31,.774,22,22,44,26,15,4,17,42,128
1989,Tony Brown,SG,28,HOU,14,0,91,14,45,.311,2,9,.222,12,36,.333,.333,6,8,.750,7,8,15,5,3,0,7,14,36
1989,Tony Brown,SF,28,MIL,29,0,274,36,73,.493,2,7,.286,34,66,.515,.507,18,23,.783,15,14,29,21,12,4,10,28,92
1989,Mark Bryant,PF,23,POR,56,32,803,120,247,.486,0,0,,120,247,.486,.486,40,69,.580,65,114,179,33,20,7,41,144,280
1989,Greg Butler,C,22,NYK,33,0,140,20,48,.417,0,3,.000,20,45,.444,.417,16,20,.800,9,19,28,2,1,2,17,28,56
1989,Michael Cage,PF,27,SEA,80,71,2536,314,630,.498,0,4,.000,314,626,.502,.498,197,265,.743,276,489,765,126,92,52,124,184,825
1989,Tony Campbell,SF,26,LAL,63,2,787,158,345,.458,2,21,.095,156,324,.481,.461,70,83,.843,53,77,130,47,37,6,62,108,388
1989,Antoine Carr,PF,27,ATL,78,12,1488,226,471,.480,0,1,.000,226,470,.481,.480,130,152,.855,106,168,274,91,31,62,82,221,582
1989,Joe Barry Carroll,C,30,NJN,64,62,1996,363,810,.448,0,0,,363,810,.448,.448,176,220,.800,118,355,473,105,71,81,143,193,902
1989,Bill Cartwright,C,31,CHI,78,76,2333,365,768,.475,0,0,,365,768,.475,.475,236,308,.766,152,369,521,90,21,41,190,234,966
1989,Terry Catledge,PF,25,WSB,79,77,2077,334,681,.490,1,5,.200,333,676,.493,.491,153,254,.602,230,342,572,75,46,25,120,250,822
1989,Ron Cavenall,C,29,NJN,5,0,16,2,3,.667,0,0,,2,3,.667,.667,2,5,.400,0,2,2,0,0,2,2,2,6
1989,Tom Chambers,PF,29,PHO,81,81,3002,774,1643,.471,28,86,.326,746,1557,.479,.480,509,598,.851,143,541,684,231,87,55,231,271,2085
1989,Mike Champion,SF,24,SEA,2,0,4,0,3,.000,0,1,.000,0,2,.000,.000,0,0,,0,0,0,0,0,0,1,2,0
1989,Rex Chapman,SG,21,CHH,75,44,2219,526,1271,.414,60,191,.314,466,1080,.431,.437,155,195,.795,74,113,187,176,70,25,113,167,1267
1989,Maurice Cheeks*,PG,32,PHI,71,70,2298,336,696,.483,1,13,.077,335,683,.490,.483,151,195,.774,39,144,183,554,105,17,116,114,824
1989,Derrick Chievous,SF,21,HOU,81,1,1539,277,634,.437,5,24,.208,272,610,.446,.441,191,244,.783,114,142,256,77,48,11,136,161,750
1989,Ben Coleman,PF,27,PHI,58,11,703,117,241,.485,0,0,,117,241,.485,.485,61,77,.792,49,128,177,17,10,18,48,120,295
1989,Steve Colter,PG,26,WSB,80,5,1425,203,457,.444,3,25,.120,200,432,.463,.447,125,167,.749,62,120,182,225,69,14,64,158,534
1989,Dallas Comegys,PF,24,SAS,67,10,1119,166,341,.487,0,2,.000,166,339,.490,.487,106,161,.658,112,122,234,30,42,63,85,160,438
1989,Lester Conner,PG,29,NJN,82,63,2532,309,676,.457,13,37,.351,296,639,.463,.467,212,269,.788,100,255,355,604,181,5,181,132,843
1989,Darwin Cook,SG,30,TOT,66,4,1143,218,478,.456,8,41,.195,210,437,.481,.464,63,78,.808,34,73,107,127,71,10,88,121,507
1989,Darwin Cook,SG,30,SAS,36,0,757,147,315,.467,6,31,.194,141,284,.496,.476,46,56,.821,21,38,59,84,43,4,62,77,346
1989,Darwin Cook,SG,30,DEN,30,4,386,71,163,.436,2,10,.200,69,153,.451,.442,17,22,.773,13,35,48,43,28,6,26,44,161
1989,Michael Cooper,SG,32,LAL,80,13,1943,213,494,.431,80,210,.381,133,284,.468,.512,81,93,.871,33,158,191,314,72,32,94,186,587
1989,Wayne Cooper,C,32,DEN,79,72,1864,220,444,.495,1,4,.250,219,440,.498,.497,79,106,.745,212,407,619,78,36,211,73,302,520
1989,Tyrone Corbin,SF,26,PHO,77,30,1655,245,454,.540,0,2,.000,245,452,.542,.540,141,179,.788,176,222,398,118,82,13,92,222,631
1989,Dave Corzine,C,32,CHI,81,7,1483,203,440,.461,2,8,.250,201,432,.465,.464,71,96,.740,92,223,315,103,29,45,93,134,479
1989,Winston Crite,SF,23,PHO,2,0,6,0,3,.000,0,0,,0,3,.000,.000,0,0,,1,0,1,0,0,0,1,1,0
1989,Pat Cummings,PF,32,MIA,53,28,1096,197,394,.500,0,2,.000,197,392,.503,.500,72,97,.742,84,197,281,47,29,18,111,160,466
1989,Terry Cummings,SF,27,MIL,80,78,2824,730,1563,.467,7,15,.467,723,1548,.467,.469,362,460,.787,281,369,650,198,106,72,201,265,1829
1989,Earl Cureton,C,31,CHH,82,41,2047,233,465,.501,0,1,.000,233,464,.502,.501,66,123,.537,188,300,488,130,50,61,114,230,532
1989,Dell Curry,SG,24,CHH,48,0,813,256,521,.491,19,55,.345,237,466,.509,.510,40,46,.870,26,78,104,50,42,4,44,68,571
1989,Quintin Dailey,SG,28,LAC,69,51,1722,448,964,.465,1,9,.111,447,955,.468,.465,217,286,.759,69,135,204,154,90,6,122,152,1114
1989,Adrian Dantley*,SF,33,TOT,73,67,2422,470,954,.493,0,1,.000,470,953,.493,.493,460,568,.810,117,200,317,171,43,13,163,186,1400
1989,Adrian Dantley*,SF,33,DET,42,42,1341,258,495,.521,0,0,,258,495,.521,.521,256,305,.839,53,111,164,93,23,6,81,99,772
1989,Adrian Dantley*,SF,33,DAL,31,25,1081,212,459,.462,0,1,.000,212,458,.463,.462,204,263,.776,64,89,153,78,20,7,82,87,628
1989,Brad Daugherty,C,23,CLE,78,78,2821,544,1012,.538,1,3,.333,543,1009,.538,.538,386,524,.737,167,551,718,285,63,40,230,175,1475
1989,Brad Davis,PG,33,DAL,78,4,1395,183,379,.483,32,102,.314,151,277,.545,.525,99,123,.805,14,94,108,242,48,18,92,151,497
1989,Charles Davis,SF,30,CHI,49,3,545,81,190,.426,4,15,.267,77,175,.440,.437,19,26,.731,47,67,114,31,11,5,22,58,185
1989,Mark Davis,SF,25,TOT,33,0,258,49,102,.480,1,10,.100,48,92,.522,.485,28,34,.824,16,21,37,14,13,5,12,39,127
1989,Mark Davis,SF,25,PHO,2,0,7,1,5,.200,0,1,.000,1,4,.250,.200,2,2,1.000,1,0,1,0,0,0,0,1,4
1989,Mark Davis,SF,25,MIL,31,0,251,48,97,.495,1,9,.111,47,88,.534,.500,26,32,.813,15,21,36,14,13,5,12,38,123
1989,Walter Davis,SG,34,DEN,81,0,1857,536,1076,.498,20,69,.290,516,1007,.512,.507,175,199,.879,41,110,151,190,72,5,132,187,1267
1989,Darryl Dawkins,C,32,DET,14,0,48,9,19,.474,0,0,,9,19,.474,.474,9,18,.500,3,4,7,1,0,1,4,13,27
1989,Johnny Dawkins,PG,25,SAS,32,30,1083,177,400,.443,0,4,.000,177,396,.447,.443,100,112,.893,32,69,101,224,55,0,111,64,454
1989,Vinny Del Negro,SG,22,SAC,80,2,1556,239,503,.475,6,20,.300,233,483,.482,.481,85,100,.850,48,123,171,206,65,14,77,160,569
1989,Fennis Dembo,SF,23,DET,31,0,74,14,42,.333,0,4,.000,14,38,.368,.333,8,10,.800,8,15,23,5,1,0,7,15,36
1989,James Donaldson,C,31,DAL,53,53,1746,193,337,.573,0,0,,193,337,.573,.573,95,124,.766,158,412,570,38,24,81,83,111,481
1989,Greg Dreiling,C,26,IND,53,4,396,43,77,.558,0,0,,43,77,.558,.558,43,64,.672,39,53,92,18,5,11,39,100,129
1989,Clyde Drexler*,SG,26,POR,78,78,3064,829,1672,.496,27,104,.260,802,1568,.511,.504,438,548,.799,289,326,615,450,213,54,250,269,2123
1989,Kevin Duckworth,C,24,POR,79,79,2662,554,1161,.477,0,2,.000,554,1159,.478,.477,324,428,.757,246,389,635,60,56,49,200,300,1432
1989,Chris Dudley,C,23,CLE,61,2,544,73,168,.435,0,1,.000,73,167,.437,.435,39,107,.364,72,85,157,21,9,23,44,82,185
1989,Joe Dumars*,SG,25,DET,69,67,2408,456,903,.505,14,29,.483,442,874,.506,.513,260,306,.850,57,115,172,390,63,5,178,103,1186
1989,Mike Dunleavy,PG,34,MIL,2,0,5,1,2,.500,1,2,.500,0,0,,.750,0,0,,0,0,0,0,0,0,0,0,3
1989,T.R. Dunn,SG,33,PHO,34,1,321,12,35,.343,0,0,,12,35,.343,.343,9,12,.750,30,30,60,25,12,1,6,35,33
1989,Ledell Eackles,SG,22,WSB,80,6,1459,318,732,.434,9,40,.225,309,692,.447,.441,272,346,.786,100,80,180,123,41,5,128,156,917
1989,Mark Eaton,C,32,UTA,82,82,2914,188,407,.462,0,0,,188,407,.462,.462,132,200,.660,227,616,843,83,40,315,142,290,508
1989,James Edwards,C,33,DET,76,1,1254,211,422,.500,0,2,.000,211,420,.502,.500,133,194,.686,68,163,231,49,11,31,72,226,555
1989,Kevin Edwards,SG,23,MIA,79,62,2349,470,1105,.425,10,37,.270,460,1068,.431,.430,144,193,.746,85,177,262,349,139,27,246,154,1094
1989,Craig Ehlo,SG,27,CLE,82,4,1867,249,524,.475,39,100,.390,210,424,.495,.512,71,117,.607,100,195,295,266,110,19,116,161,608
1989,Dale Ellis,SG,28,SEA,82,82,3190,857,1710,.501,162,339,.478,695,1371,.507,.549,377,462,.816,156,186,342,164,108,22,218,197,2253
1989,Wayne Engelstad,PF,23,DEN,11,0,50,11,29,.379,0,0,,11,29,.379,.379,6,10,.600,5,11,16,7,1,0,3,12,28
1989,Alex English*,SF,35,DEN,82,82,2990,924,1881,.491,2,8,.250,922,1873,.492,.492,325,379,.858,148,178,326,383,66,12,198,174,2175
1989,Patrick Ewing*,C,26,NYK,80,80,2896,727,1282,.567,0,6,.000,727,1276,.570,.567,361,484,.746,213,527,740,188,117,281,266,311,1815
1989,Jim Farmer,SG,24,UTA,37,0,412,57,142,.401,9,20,.450,48,122,.393,.433,29,41,.707,22,33,55,28,9,0,26,41,152
1989,Dave Feitl,C,26,WSB,57,36,828,116,266,.436,0,1,.000,116,265,.438,.436,54,65,.831,69,133,202,36,17,18,65,136,286
1989,Rolando Ferreira,C,24,POR,12,0,34,1,18,.056,0,0,,1,18,.056,.056,7,8,.875,4,9,13,1,0,1,6,7,9
1989,Duane Ferrell,SF,23,ATL,41,0,231,35,83,.422,0,0,,35,83,.422,.422,30,44,.682,19,22,41,10,7,6,12,33,100
1989,Vern Fleming,PG,26,IND,76,69,2552,419,814,.515,3,23,.130,416,791,.526,.517,243,304,.799,85,225,310,494,77,12,192,212,1084
1989,Sleepy Floyd,PG,28,HOU,82,82,2788,396,893,.443,109,292,.373,287,601,.478,.504,261,309,.845,48,258,306,709,124,11,253,196,1162
1989,Tellis Frank,PF,23,GSW,32,2,245,34,91,.374,0,1,.000,34,90,.378,.374,39,51,.765,26,35,61,15,14,6,29,59,107
1989,Anthony Frederick,SF,24,IND,46,0,313,63,125,.504,2,5,.400,61,120,.508,.512,24,34,.706,26,26,52,20,14,6,34,59,152
1989,Corey Gaines,SG,23,NJN,32,0,337,27,64,.422,1,5,.200,26,59,.441,.430,12,16,.750,3,16,19,67,15,1,20,27,67
1989,Kevin Gamble,SF,23,BOS,44,6,375,75,136,.551,2,11,.182,73,125,.584,.559,35,55,.636,11,31,42,34,14,3,19,40,187
1989,Winston Garland,PG,24,GSW,79,79,2661,466,1074,.434,10,43,.233,456,1031,.442,.439,203,251,.809,101,227,328,505,175,14,187,216,1145
1989,Tom Garrick,SG,22,LAC,71,20,1499,176,359,.490,0,13,.000,176,346,.509,.490,102,127,.803,37,119,156,243,78,9,116,141,454
1989,Kenny Gattison,PF,24,PHO,2,0,9,0,1,.000,0,0,,0,1,.000,.000,1,2,.500,0,1,1,0,0,0,0,2,1
1989,Ben Gillery,C,23,SAC,24,0,84,6,19,.316,0,0,,6,19,.316,.316,13,23,.565,7,16,23,2,2,4,5,29,25
1989,Armen Gilliam,PF,24,PHO,74,60,2120,468,930,.503,0,0,,468,930,.503,.503,240,323,.743,165,376,541,52,54,27,140,176,1176
1989,Mike Gminski,C,29,PHI,82,82,2739,556,1166,.477,0,6,.000,556,1160,.479,.477,297,341,.871,213,556,769,138,46,106,129,142,1409
1989,Grant Gondrezick,SG,26,LAC,27,0,244,38,95,.400,3,11,.273,35,84,.417,.416,26,40,.650,15,21,36,34,13,1,17,36,105
1989,Orlando Graham,PF,23,GSW,7,0,22,3,10,.300,0,0,,3,10,.300,.300,2,4,.500,8,3,11,0,0,0,2,6,8
1989,Ron Grandison,PF,24,BOS,72,0,528,59,142,.415,0,10,.000,59,132,.447,.415,59,80,.738,47,45,92,42,18,3,36,71,177
1989,Gary Grant,PG,23,LAC,71,48,1924,361,830,.435,5,22,.227,356,808,.441,.438,119,162,.735,80,158,238,506,144,9,258,170,846
1989,Harvey Grant,PF,23,WSB,71,1,1193,181,390,.464,0,1,.000,181,389,.465,.464,34,57,.596,75,88,163,79,35,29,28,147,396
1989,Horace Grant,PF,23,CHI,79,79,2809,405,781,.519,0,5,.000,405,776,.522,.519,140,199,.704,240,441,681,168,86,62,128,251,950
1989,Stuart Gray,C,25,IND,72,0,783,72,153,.471,0,1,.000,72,152,.474,.471,44,64,.688,84,161,245,29,11,21,48,128,188
1989,Sylvester Gray,SF,21,MIA,55,15,1220,167,398,.420,1,4,.250,166,394,.421,.421,105,156,.673,117,169,286,117,36,25,102,144,440
1989,Jeff Grayer,SG,23,MIL,11,2,200,32,73,.438,0,2,.000,32,71,.451,.438,17,20,.850,14,21,35,22,10,1,19,15,81
1989,A.C. Green,PF,25,LAL,82,82,2510,401,758,.529,4,17,.235,397,741,.536,.532,282,359,.786,258,481,739,103,94,55,119,172,1088
1989,Rickey Green,PG,34,TOT,63,2,871,129,264,.489,3,11,.273,126,253,.498,.494,30,33,.909,11,58,69,187,40,2,61,35,291
1989,Rickey Green,PG,34,CHH,33,2,370,57,132,.432,1,5,.200,56,127,.441,.436,13,14,.929,4,19,23,82,18,0,28,16,128
1989,Rickey Green,PG,34,MIL,30,0,501,72,132,.545,2,6,.333,70,126,.556,.553,17,19,.895,7,39,46,105,22,2,33,19,163
1989,Sidney Green,PF,28,NYK,82,0,1277,194,422,.460,0,3,.000,194,419,.463,.460,129,170,.759,157,237,394,76,47,18,125,172,517
1989,Dave Greenwood,PF,31,TOT,67,18,1403,167,395,.423,0,0,,167,395,.423,.423,132,176,.750,140,262,402,96,47,52,91,201,466
1989,Dave Greenwood,PF,31,SAS,38,15,912,105,247,.425,0,0,,105,247,.425,.425,84,105,.800,92,146,238,55,30,24,55,123,294
1989,Dave Greenwood,PF,31,DEN,29,3,491,62,148,.419,0,0,,62,148,.419,.419,48,71,.676,48,116,164,41,17,28,36,78,172
1989,Darrell Griffith,SG,30,UTA,82,73,2382,466,1045,.446,61,196,.311,405,849,.477,.475,142,182,.780,77,253,330,130,86,22,141,175,1135
1989,Pétur Guðmundsson,C,30,SAS,5,3,70,9,25,.360,0,0,,9,25,.360,.360,3,4,.750,5,11,16,5,1,1,8,15,21
1989,Jack Haley,PF,25,CHI,51,1,289,37,78,.474,0,0,,37,78,.474,.474,36,46,.783,21,50,71,10,11,0,26,56,110
1989,Bob Hansen,SG,28,UTA,46,9,964,140,300,.467,19,54,.352,121,246,.492,.498,42,75,.560,29,99,128,50,37,6,43,105,341
1989,Bill Hanzlik,PF,31,DEN,41,0,701,66,151,.437,1,5,.200,65,146,.445,.440,68,87,.782,18,75,93,86,25,5,53,82,201
1989,Derek Harper,PG,27,DAL,81,81,2968,538,1127,.477,99,278,.356,439,849,.517,.521,229,284,.806,46,182,228,570,172,41,205,219,1404
1989,Ron Harper,SG,25,CLE,82,82,2851,587,1149,.511,29,116,.250,558,1033,.540,.523,323,430,.751,122,287,409,434,185,74,230,224,1526
1989,Steve Harris,SG,25,DET,3,0,7,1,4,.250,0,0,,1,4,.250,.250,2,2,1.000,0,2,2,0,1,0,0,1,4
1989,Scott Hastings,C,28,MIA,75,6,1206,143,328,.436,9,28,.321,134,300,.447,.450,91,107,.850,72,159,231,59,32,42,68,203,386
1989,Hersey Hawkins,SG,22,PHI,79,79,2577,442,971,.455,71,166,.428,371,805,.461,.492,241,290,.831,51,174,225,239,120,37,158,184,1196
1989,Gerald Henderson,PG,33,PHI,65,0,986,144,348,.414,33,107,.308,111,241,.461,.461,104,127,.819,17,51,68,140,42,3,73,121,425
1989,Rod Higgins,PF,29,GSW,81,1,1887,301,633,.476,66,168,.393,235,465,.505,.528,188,229,.821,111,265,376,160,39,42,76,172,856
1989,Roy Hinson,SF,27,NJN,82,39,2542,495,1027,.482,0,2,.000,495,1025,.483,.482,318,420,.757,152,370,522,71,34,121,165,298,1308
1989,Craig Hodges,SG,28,TOT,59,6,1204,203,430,.472,75,180,.417,128,250,.512,.559,48,57,.842,23,66,89,146,43,4,57,90,529
1989,Craig Hodges,SG,28,PHO,10,0,92,16,36,.444,4,12,.333,12,24,.500,.500,3,4,.750,2,3,5,8,2,0,5,8,39
1989,Craig Hodges,SG,28,CHI,49,6,1112,187,394,.475,71,168,.423,116,226,.513,.565,45,53,.849,21,63,84,138,41,4,52,82,490
1989,Michael Holton,PG,27,CHH,67,60,1696,215,504,.427,3,14,.214,212,490,.433,.430,120,143,.839,30,75,105,424,66,12,119,165,553
1989,Dave Hoppen,C,24,CHH,77,36,1419,199,353,.564,1,2,.500,198,351,.564,.565,101,139,.727,123,261,384,57,25,21,77,239,500
1989,Dennis Hopson,SG,23,NJN,62,36,1551,299,714,.419,4,27,.148,295,687,.429,.422,186,219,.849,91,111,202,103,70,30,102,150,788
1989,Tito Horford,C,23,MIL,25,0,112,15,46,.326,0,0,,15,46,.326,.326,12,19,.632,9,13,22,3,1,7,15,14,42
1989,Jeff Hornacek,SG,25,PHO,78,73,2487,440,889,.495,27,81,.333,413,808,.511,.510,147,178,.826,75,191,266,465,129,8,111,188,1054
1989,Phil Hubbard,SF,32,CLE,31,0,191,28,63,.444,0,0,,28,63,.444,.444,17,25,.680,14,26,40,11,6,0,9,20,73
1989,Eddie Hughes,PG,28,DEN,26,1,224,28,64,.438,7,22,.318,21,42,.500,.492,7,12,.583,6,13,19,35,17,2,11,30,70
1989,Jay Humphries,PG,26,MIL,73,50,2220,345,714,.483,25,94,.266,320,620,.516,.501,129,158,.816,70,119,189,405,142,5,160,187,844
1989,Marc Iavaroni,PF,32,UTA,77,50,796,72,163,.442,0,1,.000,72,162,.444,.442,36,44,.818,41,91,132,32,11,13,52,99,180
1989,Mark Jackson,PG,23,NYK,72,72,2477,479,1025,.467,81,240,.338,398,785,.507,.507,180,258,.698,106,235,341,619,139,7,226,163,1219
1989,Michael Jackson,PG,24,SAC,14,0,70,9,24,.375,2,6,.333,7,18,.389,.417,1,2,.500,1,3,4,11,3,0,4,12,21
1989,Avery Johnson,PG,23,SEA,43,0,291,29,83,.349,1,9,.111,28,74,.378,.355,9,16,.563,11,13,24,73,21,3,18,34,68
1989,Buck Johnson,SF,25,HOU,67,51,1850,270,515,.524,1,9,.111,269,506,.532,.525,101,134,.754,114,172,286,126,64,35,110,213,642
1989,Dennis Johnson*,PG,34,BOS,72,72,2309,277,638,.434,7,50,.140,270,588,.459,.440,160,195,.821,31,159,190,472,94,21,175,211,721
1989,Eddie Johnson,SF,29,PHO,70,7,2043,608,1224,.497,71,172,.413,537,1052,.510,.526,217,250,.868,91,215,306,162,47,7,122,198,1504
1989,Frank Johnson,PG,30,HOU,67,0,879,109,246,.443,1,6,.167,108,240,.450,.445,75,93,.806,22,57,79,181,42,0,102,91,294
1989,Kevin Johnson,PG,22,PHO,81,81,3179,570,1128,.505,2,22,.091,568,1106,.514,.506,508,576,.882,46,294,340,991,135,24,322,226,1650
1989,Magic Johnson*,PG,29,LAL,77,77,2886,579,1137,.509,59,188,.314,520,949,.548,.535,513,563,.911,111,496,607,988,138,22,312,172,1730
1989,Steve Johnson,C,31,POR,72,11,1477,296,565,.524,0,0,,296,565,.524,.524,129,245,.527,135,223,358,105,20,44,140,254,721
1989,Vinnie Johnson,SG,32,DET,82,21,2073,462,996,.464,13,44,.295,449,952,.472,.470,193,263,.734,109,146,255,242,74,17,105,155,1130
1989,Anthony Jones,SG,26,TOT,33,0,196,29,79,.367,4,16,.250,25,63,.397,.392,14,16,.875,14,14,28,17,11,3,5,20,76
1989,Anthony Jones,SG,26,CHI,8,0,65,5,15,.333,0,1,.000,5,14,.357,.333,2,2,1.000,4,4,8,4,2,1,1,7,12
1989,Anthony Jones,SG,26,DAL,25,0,131,24,64,.375,4,15,.267,20,49,.408,.406,12,14,.857,10,10,20,13,9,2,4,13,64
1989,Bill Jones,PF,22,NJN,37,0,307,50,102,.490,0,1,.000,50,101,.495,.490,29,43,.674,20,27,47,20,17,6,18,38,129
1989,Caldwell Jones,PF,38,POR,72,40,1279,77,183,.421,0,1,.000,77,182,.423,.421,48,61,.787,88,212,300,59,24,85,83,166,202
1989,Charles Jones,C,31,WSB,53,45,1154,60,125,.480,0,1,.000,60,124,.484,.480,16,25,.640,77,180,257,42,39,76,39,187,136
1989,Charles Jones,PF,27,WSB,43,0,516,38,82,.463,1,3,.333,37,79,.468,.470,33,53,.623,54,86,140,18,18,16,22,49,110
1989,Shelton Jones,SF,22,TOT,51,34,682,93,209,.445,0,1,.000,93,208,.447,.445,58,80,.725,32,81,113,42,21,15,47,58,244
1989,Shelton Jones,SF,22,SAS,7,0,92,9,25,.360,0,0,,9,25,.360,.360,8,13,.615,6,10,16,7,2,2,7,8,26
1989,Shelton Jones,SF,22,GSW,2,0,13,3,5,.600,0,0,,3,5,.600,.600,0,0,,2,0,2,2,3,0,1,0,6
1989,Shelton Jones,SF,22,PHI,42,34,577,81,179,.453,0,1,.000,81,178,.455,.453,50,67,.746,24,71,95,33,16,13,39,50,212
1989,Michael Jordan*,SG,25,CHI,81,81,3255,966,1795,.538,27,98,.276,939,1697,.553,.546,674,793,.850,149,503,652,650,234,65,290,247,2633
1989,Tim Kempton,PF,25,CHH,79,0,1341,171,335,.510,0,1,.000,171,334,.512,.510,142,207,.686,91,213,304,102,41,14,121,215,484
1989,Steve Kerr,PG,23,PHO,26,0,157,20,46,.435,8,17,.471,12,29,.414,.522,6,9,.667,3,14,17,24,7,0,6,12,54
1989,Jerome Kersey,SF,26,POR,76,76,2716,533,1137,.469,6,21,.286,527,1116,.472,.471,258,372,.694,246,383,629,243,137,84,167,277,1330
1989,Randolph Keys,SF,22,CLE,42,0,331,74,172,.430,1,10,.100,73,162,.451,.433,20,29,.690,23,33,56,19,12,6,21,51,169
1989,Albert King,SF,29,SAS,46,11,791,141,327,.431,8,32,.250,133,295,.451,.443,37,48,.771,33,107,140,79,27,7,74,97,327
1989,Bernard King*,SF,32,WSB,81,81,2559,654,1371,.477,5,30,.167,649,1341,.484,.479,361,441,.819,133,251,384,294,64,13,227,219,1674
1989,Greg Kite,C,27,TOT,70,24,942,65,151,.430,0,0,,65,151,.430,.430,20,41,.488,81,162,243,36,27,54,58,161,150
1989,Greg Kite,C,27,LAC,58,12,729,49,121,.405,0,0,,49,121,.405,.405,14,31,.452,66,124,190,29,23,46,46,118,112
1989,Greg Kite,C,27,CHH,12,12,213,16,30,.533,0,0,,16,30,.533,.533,6,10,.600,15,38,53,7,4,8,12,43,38
1989,Joe Kleine,C,27,TOT,75,13,1411,175,432,.405,0,2,.000,175,430,.407,.405,134,152,.882,124,254,378,67,33,23,104,192,484
1989,Joe Kleine,C,27,SAC,47,11,913,116,303,.383,0,1,.000,116,302,.384,.383,81,88,.920,75,166,241,35,18,18,67,126,313
1989,Joe Kleine,C,27,BOS,28,2,498,59,129,.457,0,1,.000,59,128,.461,.457,53,64,.828,49,88,137,32,15,5,37,66,171
1989,Bart Kofoed,SG,24,UTA,19,0,176,12,33,.364,0,1,.000,12,32,.375,.364,6,11,.545,4,7,11,20,9,0,13,22,30
1989,Jon Koncak,C,25,ATL,74,22,1531,141,269,.524,0,3,.000,141,266,.530,.524,63,114,.553,147,306,453,56,54,98,60,238,345
1989,Larry Krystkowiak,PF,24,MIL,80,77,2472,362,766,.473,4,12,.333,358,754,.475,.475,289,351,.823,198,412,610,107,93,9,147,219,1017
1989,Bill Laimbeer,C,31,DET,81,81,2640,449,900,.499,30,86,.349,419,814,.515,.516,178,212,.840,138,638,776,177,51,100,129,259,1106
1989,Jeff Lamp,SF,29,LAL,37,0,176,27,69,.391,2,4,.500,25,65,.385,.406,4,5,.800,6,28,34,15,8,2,16,27,60
1989,Jerome Lane,PF,22,DEN,54,1,550,109,256,.426,0,7,.000,109,249,.438,.426,43,112,.384,87,113,200,60,20,4,50,105,261
1989,Andrew Lang,C,22,PHO,62,25,526,60,117,.513,0,0,,60,117,.513,.513,39,60,.650,54,93,147,9,17,48,28,112,159
1989,Allen Leavell,SG,31,HOU,55,3,627,65,188,.346,5,41,.122,60,147,.408,.359,44,60,.733,13,40,53,127,25,5,62,61,179
1989,Eric Leckner,C,22,UTA,75,0,779,120,220,.545,0,0,,120,220,.545,.545,79,113,.699,48,151,199,16,8,22,69,174,319
1989,Keith Lee,PF,26,NJN,57,4,840,109,258,.422,0,2,.000,109,256,.426,.422,53,71,.746,73,186,259,42,20,33,53,138,271
1989,Jim Les,PG,25,UTA,82,0,781,40,133,.301,1,14,.071,39,119,.328,.305,57,73,.781,23,64,87,215,27,5,88,88,138
1989,Fat Lever,SG,28,DEN,71,71,2745,558,1221,.457,23,66,.348,535,1155,.463,.466,270,344,.785,187,475,662,559,195,20,157,178,1409
1989,Cliff Levingston,PF,28,ATL,80,52,2184,300,568,.528,1,5,.200,299,563,.531,.529,133,191,.696,194,304,498,75,97,70,105,270,734
1989,Ralph Lewis,SF,25,CHH,42,0,336,58,121,.479,1,3,.333,57,118,.483,.483,19,39,.487,35,26,61,15,11,3,24,28,136
1989,Reggie Lewis,SF,23,BOS,81,57,2657,604,1242,.486,3,22,.136,601,1220,.493,.488,284,361,.787,116,261,377,218,124,72,142,258,1495
1989,Alton Lister,C,30,SEA,82,82,1806,271,543,.499,0,0,,271,543,.499,.499,115,178,.646,207,338,545,54,28,180,117,310,657
1989,Rob Lock,PF,22,LAC,20,0,110,9,32,.281,0,0,,9,32,.281,.281,12,15,.800,14,18,32,4,3,4,13,15,30
1989,Brad Lohaus,PF,24,TOT,77,25,1214,210,486,.432,1,11,.091,209,475,.440,.433,81,103,.786,84,172,256,66,30,56,77,161,502
1989,Brad Lohaus,PF,24,BOS,48,15,738,117,270,.433,0,4,.000,117,266,.440,.433,35,46,.761,47,95,142,49,21,26,49,101,269
1989,Brad Lohaus,PF,24,SAC,29,10,476,93,216,.431,1,7,.143,92,209,.440,.433,46,57,.807,37,77,114,17,9,30,28,60,233
1989,Grant Long,PF,22,MIA,82,73,2435,336,692,.486,0,5,.000,336,687,.489,.486,304,406,.749,240,306,546,149,122,48,201,337,976
1989,John Long,SG,32,TOT,68,1,919,147,359,.409,8,20,.400,139,339,.410,.421,70,76,.921,18,59,77,80,29,3,57,84,372
1989,John Long,SG,32,IND,44,1,767,128,319,.401,8,20,.400,120,299,.401,.414,59,63,.937,16,50,66,65,29,1,48,68,323
1989,John Long,SG,32,DET,24,0,152,19,40,.475,0,0,,19,40,.475,.475,11,13,.846,2,9,11,15,0,2,9,16,49
1989,Sidney Lowe,SG,29,CHH,14,0,250,8,25,.320,0,2,.000,8,23,.348,.320,7,11,.636,6,28,34,93,14,0,9,28,23
1989,John Lucas,PG,35,SEA,74,8,842,119,299,.398,18,68,.265,101,231,.437,.428,54,77,.701,22,57,79,260,60,1,66,53,310
1989,Rick Mahorn,PF,30,DET,72,61,1795,203,393,.517,0,2,.000,203,391,.519,.517,116,155,.748,141,355,496,59,40,66,97,206,522
1989,Dan Majerle,SG,23,PHO,54,5,1354,181,432,.419,27,82,.329,154,350,.440,.450,78,127,.614,62,147,209,130,63,14,48,139,467
1989,Jeff Malone,SG,27,WSB,76,75,2418,677,1410,.480,1,19,.053,676,1391,.486,.480,296,340,.871,55,124,179,219,39,14,165,155,1651
1989,Karl Malone*,PF,25,UTA,80,80,3126,809,1559,.519,5,16,.313,804,1543,.521,.521,703,918,.766,259,594,853,219,144,70,285,286,2326
1989,Moses Malone*,C,33,ATL,81,80,2878,538,1096,.491,0,12,.000,538,1084,.496,.491,561,711,.789,386,570,956,112,79,100,245,154,1637
1989,Danny Manning,PF,22,LAC,26,18,950,177,358,.494,1,5,.200,176,353,.499,.496,79,103,.767,70,101,171,81,44,25,93,89,434
1989,Pace Mannion,SF,28,TOT,10,0,32,4,8,.500,0,2,.000,4,6,.667,.500,0,0,,0,5,5,2,3,0,3,5,8
1989,Pace Mannion,SF,28,DET,5,0,14,2,2,1.000,0,0,,2,2,1.000,1.000,0,0,,0,3,3,0,1,0,0,3,4
1989,Pace Mannion,SF,28,ATL,5,0,18,2,6,.333,0,2,.000,2,4,.500,.333,0,0,,0,2,2,2,2,0,3,2,4
1989,Vernon Maxwell,SG,23,SAS,79,36,2065,357,827,.432,32,129,.248,325,698,.466,.451,181,243,.745,49,153,202,301,86,8,178,136,927
1989,Tim McCormick,C,26,HOU,81,0,1257,169,351,.481,0,4,.000,169,347,.487,.481,87,129,.674,87,174,261,54,18,24,68,193,425
1989,Rodney McCray,SF,27,SAC,68,65,2435,340,729,.466,5,22,.227,335,707,.474,.470,169,234,.722,143,371,514,293,57,36,168,121,854
1989,Xavier McDaniel,SF,25,SEA,82,10,2385,677,1385,.489,11,36,.306,666,1349,.494,.493,312,426,.732,177,256,433,134,84,40,210,231,1677
1989,Ben McDonald,PF,26,GSW,11,0,103,13,19,.684,0,0,,13,19,.684,.684,9,15,.600,4,8,12,5,4,0,3,11,35
1989,Mike McGee,SG,29,NJN,80,49,2027,434,917,.473,93,255,.365,341,662,.515,.524,77,144,.535,73,116,189,116,80,12,124,184,1038
1989,Kevin McHale*,PF,31,BOS,78,74,2876,661,1211,.546,0,4,.000,661,1207,.548,.546,436,533,.818,223,414,637,172,26,97,196,223,1758
1989,Derrick McKey,SF,22,SEA,82,82,2804,487,970,.502,30,89,.337,457,881,.519,.518,301,375,.803,167,297,464,219,105,70,188,264,1305
1989,Nate McMillan,PG,24,SEA,75,74,2341,199,485,.410,15,70,.214,184,415,.443,.426,119,189,.630,143,245,388,696,156,42,211,236,532
1989,Mark McNamara,C,29,LAL,39,0,318,32,64,.500,0,0,,32,64,.500,.500,49,78,.628,38,62,100,10,4,3,24,51,113
1989,Reggie Miller*,SG,23,IND,74,70,2536,398,831,.479,98,244,.402,300,587,.511,.538,287,340,.844,73,219,292,227,93,29,143,170,1181
1989,Todd Mitchell,SF,22,TOT,24,0,353,43,97,.443,0,0,,43,97,.443,.443,37,64,.578,18,32,50,21,16,2,33,51,123
1989,Todd Mitchell,SF,22,MIA,22,0,320,41,88,.466,0,0,,41,88,.466,.466,36,60,.600,17,30,47,20,15,2,29,49,118
1989,Todd Mitchell,SF,22,SAS,2,0,33,2,9,.222,0,0,,2,9,.222,.222,1,4,.250,1,2,3,1,1,0,4,2,5
1989,Paul Mokeski,C,32,MIL,74,0,690,59,164,.360,7,26,.269,52,138,.377,.381,40,51,.784,63,124,187,36,29,21,35,153,165
1989,Sidney Moncrief*,PG,31,MIL,62,50,1594,261,532,.491,25,73,.342,236,459,.514,.514,205,237,.865,46,126,172,188,65,13,94,114,752
1989,Chris Morris,SF,23,NJN,76,48,2096,414,905,.457,64,175,.366,350,730,.479,.493,182,254,.717,188,209,397,119,102,60,190,250,1074
1989,Richard Morton,PG,22,IND,2,0,11,3,4,.750,0,0,,3,4,.750,.750,0,0,,0,0,0,1,0,0,1,2,6
1989,Chris Mullin*,SF,25,GSW,82,82,3093,830,1630,.509,23,100,.230,807,1530,.527,.516,493,553,.892,152,331,483,415,176,39,296,178,2176
1989,Pete Myers,SG,25,TOT,33,0,270,31,73,.425,0,2,.000,31,71,.437,.425,33,48,.688,15,18,33,48,20,2,23,44,95
1989,Pete Myers,SG,25,PHI,4,0,40,6,12,.500,0,0,,6,12,.500,.500,2,4,.500,3,7,10,2,3,0,4,3,14
1989,Pete Myers,SG,25,NYK,29,0,230,25,61,.410,0,2,.000,25,59,.424,.410,31,44,.705,12,11,23,46,17,2,19,41,81
1989,Larry Nance,PF,29,CLE,73,72,2526,496,920,.539,0,4,.000,496,916,.541,.539,267,334,.799,156,425,581,159,57,206,117,186,1259
1989,Calvin Natt,SF,32,TOT,24,0,353,47,116,.405,0,1,.000,47,115,.409,.405,57,79,.722,28,50,78,18,8,3,30,32,151
1989,Calvin Natt,SF,32,DEN,14,0,168,22,50,.440,0,1,.000,22,49,.449,.440,22,31,.710,12,34,46,7,6,1,11,13,66
1989,Calvin Natt,SF,32,SAS,10,0,185,25,66,.379,0,0,,25,66,.379,.379,35,48,.729,16,16,32,11,2,2,19,19,85
1989,Craig Neal,PG,24,TOT,53,0,500,45,123,.366,10,34,.294,35,89,.393,.407,14,23,.609,7,22,29,118,24,4,54,70,114
1989,Craig Neal,PG,24,POR,21,0,159,11,35,.314,2,9,.222,9,26,.346,.343,1,2,.500,3,8,11,32,9,0,14,24,25
1989,Craig Neal,PG,24,MIA,32,0,341,34,88,.386,8,25,.320,26,63,.413,.432,13,21,.619,4,14,18,86,15,4,40,46,89
1989,Ed Nealy,PF,28,TOT,43,0,258,13,36,.361,0,2,.000,13,34,.382,.361,4,9,.444,22,56,78,14,7,1,7,45,30
1989,Ed Nealy,PF,28,CHI,13,0,94,5,7,.714,0,0,,5,7,.714,.714,1,2,.500,4,19,23,6,3,1,1,23,11
1989,Ed Nealy,PF,28,PHO,30,0,164,8,29,.276,0,2,.000,8,27,.296,.276,3,7,.429,18,37,55,8,4,0,6,22,19
1989,Chuck Nevitt,C,29,HOU,43,0,228,27,62,.435,0,0,,27,62,.435,.435,11,16,.688,17,47,64,3,5,29,22,51,65
1989,Johnny Newman,SF,25,NYK,81,80,2336,455,957,.475,97,287,.338,358,670,.534,.526,286,351,.815,93,113,206,162,111,23,153,259,1293
1989,Norm Nixon,PG,33,LAC,53,30,1318,153,370,.414,8,29,.276,145,341,.425,.424,48,65,.738,13,65,78,339,46,0,118,69,362
1989,Ken Norman,SF,24,LAC,80,79,3020,638,1271,.502,4,21,.190,634,1250,.507,.504,170,270,.630,245,422,667,277,106,66,206,223,1450
1989,Charles Oakley,PF,25,NYK,82,82,2604,426,835,.510,12,48,.250,414,787,.526,.517,197,255,.773,343,518,861,187,104,14,248,270,1061
1989,Hakeem Olajuwon*,C,26,HOU,82,82,3024,790,1556,.508,0,10,.000,790,1546,.511,.508,454,652,.696,338,767,1105,149,213,282,275,329,2034
1989,José Ortiz,PF,25,UTA,51,15,327,55,125,.440,0,1,.000,55,124,.444,.440,31,52,.596,30,28,58,11,8,7,36,40,141
1989,Robert Parish*,C,35,BOS,80,80,2840,596,1045,.570,0,0,,596,1045,.570,.570,294,409,.719,342,654,996,175,79,116,200,209,1486
1989,Jim Paxson,PG,31,BOS,57,7,1138,202,445,.454,4,24,.167,198,421,.470,.458,84,103,.816,18,56,74,107,38,8,57,96,492
1989,John Paxson,PG,28,CHI,78,20,1738,246,513,.480,44,133,.331,202,380,.532,.522,31,36,.861,13,81,94,308,53,6,71,162,567
1989,Will Perdue,C,23,CHI,30,0,190,29,72,.403,0,0,,29,72,.403,.403,8,14,.571,18,27,45,11,4,6,15,38,66
1989,Sam Perkins,PF,27,DAL,78,77,2860,445,959,.464,7,38,.184,438,921,.476,.468,274,329,.833,235,453,688,127,76,92,141,224,1171
1989,Tim Perry,C,23,PHO,62,15,614,108,201,.537,1,4,.250,107,197,.543,.540,40,65,.615,61,71,132,18,19,32,37,47,257
1989,Chuck Person,SF,24,IND,80,79,3012,711,1453,.489,63,205,.307,648,1248,.519,.511,243,307,.792,144,372,516,289,83,18,308,280,1728
1989,Jim Petersen,C,26,SAC,66,40,1633,278,606,.459,0,8,.000,278,598,.465,.459,115,154,.747,121,292,413,81,47,68,147,236,671
1989,Ricky Pierce,SG,29,MIL,75,4,2078,527,1018,.518,8,36,.222,519,982,.529,.522,255,297,.859,82,115,197,156,77,19,112,193,1317
1989,Ed Pinckney,PF,25,TOT,80,33,2012,319,622,.513,0,6,.000,319,616,.518,.513,280,350,.800,166,283,449,118,83,66,119,202,918
1989,Ed Pinckney,PF,25,SAC,51,24,1334,224,446,.502,0,6,.000,224,440,.509,.502,177,221,.801,106,195,301,74,54,43,81,125,625
1989,Ed Pinckney,PF,25,BOS,29,9,678,95,176,.540,0,0,,95,176,.540,.540,103,129,.798,60,88,148,44,29,23,38,77,293
1989,Scottie Pippen*,SF,23,CHI,73,56,2413,413,867,.476,21,77,.273,392,790,.496,.488,201,301,.668,138,307,445,256,139,61,199,261,1048
1989,Olden Polynice,C,24,SEA,80,0,835,91,180,.506,0,2,.000,91,178,.511,.506,51,86,.593,98,108,206,21,37,30,46,164,233
1989,Dave Popson,PF,24,TOT,17,0,106,16,40,.400,0,0,,16,40,.400,.400,2,4,.500,12,15,27,8,1,3,10,17,34
1989,Dave Popson,PF,24,LAC,10,0,68,11,25,.440,0,0,,11,25,.440,.440,1,2,.500,5,11,16,6,1,2,6,9,23
1989,Dave Popson,PF,24,MIA,7,0,38,5,15,.333,0,0,,5,15,.333,.333,1,2,.500,7,4,11,2,0,1,4,8,11
1989,Terry Porter,PG,25,POR,81,81,3102,540,1146,.471,79,219,.361,461,927,.497,.506,272,324,.840,85,282,367,770,146,8,248,187,1431
1989,Paul Pressey,SG,30,MIL,67,62,2170,307,648,.474,12,55,.218,295,593,.497,.483,187,241,.776,73,189,262,439,119,44,184,221,813
1989,Dominic Pressley,PG,24,TOT,13,0,124,9,31,.290,0,2,.000,9,29,.310,.290,5,9,.556,3,12,15,26,4,0,11,11,23
1989,Dominic Pressley,PG,24,WSB,10,0,107,8,25,.320,0,0,,8,25,.320,.320,5,9,.556,3,11,14,22,4,0,11,9,21
1989,Dominic Pressley,PG,24,CHI,3,0,17,1,6,.167,0,2,.000,1,4,.250,.167,0,0,,0,1,1,4,0,0,0,2,2
1989,Harold Pressley,PF,25,SAC,80,36,2257,383,873,.439,119,295,.403,264,578,.457,.507,96,123,.780,216,269,485,174,93,76,124,215,981
1989,Mark Price,PG,24,CLE,75,74,2728,529,1006,.526,93,211,.441,436,795,.548,.572,263,292,.901,48,178,226,631,115,7,212,98,1414
1989,Kurt Rambis,PF,30,CHH,75,75,2233,325,627,.518,0,3,.000,325,624,.521,.518,182,248,.734,269,434,703,159,100,57,148,208,832
1989,Blair Rasmussen,C,26,DEN,77,22,1308,257,577,.445,0,0,,257,577,.445,.445,69,81,.852,105,182,287,49,29,41,49,194,583
1989,Robert Reid,SF,33,CHH,82,54,2152,519,1214,.428,17,52,.327,502,1162,.432,.435,152,196,.776,82,220,302,153,53,20,106,235,1207
1989,Jerry Reynolds,SG,26,SEA,56,0,737,149,357,.417,3,15,.200,146,342,.427,.422,127,167,.760,49,51,100,62,53,26,57,58,428
1989,Mitch Richmond*,SG,23,GSW,79,79,2717,649,1386,.468,33,90,.367,616,1296,.475,.480,410,506,.810,158,310,468,334,82,13,269,223,1741
1989,Ramón Rivas,C,22,BOS,28,0,91,12,31,.387,0,1,.000,12,30,.400,.387,16,25,.640,9,15,24,3,4,1,9,21,40
1989,David Rivers,PG,24,LAL,47,0,440,49,122,.402,1,6,.167,48,116,.414,.406,35,42,.833,13,30,43,106,23,9,61,50,134
1989,Doc Rivers,PG,27,ATL,76,76,2462,371,816,.455,43,124,.347,328,692,.474,.481,247,287,.861,89,197,286,525,181,40,158,263,1032
1989,Fred Roberts,PF,28,MIL,71,3,1251,155,319,.486,3,14,.214,152,305,.498,.491,104,129,.806,68,141,209,66,36,23,80,126,417
1989,Alvin Robertson,SG,26,SAS,65,65,2287,465,962,.483,9,45,.200,456,917,.497,.488,183,253,.723,157,227,384,393,197,36,231,259,1122
1989,Cliff Robinson,SF,28,PHI,14,13,416,90,187,.481,0,1,.000,90,186,.484,.481,32,44,.727,19,56,75,32,17,2,34,37,212
1989,Dennis Rodman*,SF,27,DET,82,8,2208,316,531,.595,6,26,.231,310,505,.614,.601,97,155,.626,327,445,772,99,55,76,126,292,735
1989,Tree Rollins,C,33,CLE,60,2,583,62,138,.449,0,1,.000,62,137,.453,.449,12,19,.632,38,101,139,19,11,38,22,89,136
1989,Rob Rose,SG,24,LAC,2,0,3,0,1,.000,0,0,,0,1,.000,.000,0,0,,1,1,2,0,0,0,0,0,0
1989,Scott Roth,SF,25,TOT,63,3,536,59,167,.353,3,16,.188,56,151,.371,.362,60,87,.690,20,44,64,55,24,5,40,69,181
1989,Scott Roth,SF,25,UTA,16,0,72,7,24,.292,1,6,.167,6,18,.333,.313,8,11,.727,0,8,8,7,5,1,7,14,23
1989,Scott Roth,SF,25,SAS,47,3,464,52,143,.364,2,10,.200,50,133,.376,.371,52,76,.684,20,36,56,48,19,4,33,55,158
1989,Jim Rowinski,PF-C,28,TOT,9,0,15,1,4,.250,0,0,,1,4,.250,.250,5,6,.833,1,4,5,0,0,0,0,0,7
1989,Jim Rowinski,PF,28,DET,6,0,8,0,2,.000,0,0,,0,2,.000,.000,4,4,1.000,0,2,2,0,0,0,0,0,4
1989,Jim Rowinski,C,28,PHI,3,0,7,1,2,.500,0,0,,1,2,.500,.500,1,2,.500,1,2,3,0,0,0,0,0,3
1989,Brian Rowsom,PF,23,CHH,34,0,517,80,162,.494,1,1,1.000,79,161,.491,.497,65,81,.802,56,81,137,24,10,12,18,69,226
1989,John Salley,PF,24,DET,67,21,1458,166,333,.498,0,2,.000,166,331,.502,.498,135,195,.692,134,201,335,75,40,72,100,197,467
1989,Ralph Sampson*,C,28,GSW,61,36,1086,164,365,.449,3,8,.375,161,357,.451,.453,62,95,.653,105,202,307,77,31,65,90,170,393
1989,Mike Sanders,SF,28,CLE,82,82,2102,332,733,.453,3,10,.300,329,723,.455,.455,97,135,.719,98,209,307,133,89,32,104,230,764
1989,Danny Schayes,C,29,DEN,76,64,1918,317,607,.522,3,9,.333,314,598,.525,.525,332,402,.826,142,358,500,105,42,81,160,320,969
1989,Russ Schoene,PF,28,SEA,69,1,774,135,349,.387,42,110,.382,93,239,.389,.447,46,57,.807,58,107,165,36,37,24,48,136,358
1989,Detlef Schrempf,PF,26,TOT,69,13,1850,274,578,.474,7,35,.200,267,543,.492,.480,273,350,.780,126,269,395,179,53,19,133,220,828
1989,Detlef Schrempf,PF,26,DAL,37,1,845,112,263,.426,2,16,.125,110,247,.445,.430,127,161,.789,56,110,166,86,24,9,56,118,353
1989,Detlef Schrempf,PF,26,IND,32,12,1005,162,315,.514,5,19,.263,157,296,.530,.522,146,189,.772,70,159,229,93,29,10,77,102,475
1989,Byron Scott,SG,27,LAL,74,73,2605,588,1198,.491,77,193,.399,511,1005,.508,.523,195,226,.863,72,230,302,231,114,27,157,181,1448
1989,Rony Seikaly,C,23,MIA,78,62,1962,333,744,.448,1,4,.250,332,740,.449,.448,181,354,.511,204,345,549,55,46,96,200,258,848
1989,Brad Sellers,PF,26,CHI,80,25,1732,231,476,.485,3,6,.500,228,470,.485,.488,86,101,.851,85,142,227,99,35,69,72,176,551
1989,Charles Shackleford,C,22,NJN,60,0,484,83,168,.494,0,1,.000,83,167,.497,.494,21,42,.500,50,103,153,21,15,18,27,71,187
1989,John Shasky,C,24,MIA,65,4,944,121,248,.488,0,2,.000,121,246,.492,.488,115,167,.689,96,136,232,22,14,13,46,94,357
1989,Brian Shaw,SG,22,BOS,82,54,2301,297,686,.433,0,13,.000,297,673,.441,.433,109,132,.826,119,257,376,472,78,27,188,211,703
1989,Purvis Short,SF,31,HOU,65,16,1157,198,480,.413,9,33,.273,189,447,.423,.422,77,89,.865,65,114,179,107,44,13,70,116,482
1989,Jerry Sichting,PG,32,POR,25,1,390,46,104,.442,3,12,.250,43,92,.467,.457,7,8,.875,9,20,29,59,15,0,25,17,102
1989,Jack Sikma*,C,33,MIL,80,80,2587,360,835,.431,82,216,.380,278,619,.449,.480,266,294,.905,141,482,623,289,85,61,145,300,1068
1989,Scott Skiles,PG,24,IND,80,13,1571,198,442,.448,20,75,.267,178,367,.485,.471,130,144,.903,21,128,149,390,64,2,177,151,546
1989,Keith Smart,PG,24,SAS,2,0,12,0,2,.000,0,1,.000,0,1,.000,.000,2,2,1.000,0,1,1,2,0,0,2,0,2
1989,Charles Smith,PF,23,LAC,71,56,2161,435,878,.495,0,3,.000,435,875,.497,.495,285,393,.725,173,292,465,103,68,89,146,273,1155
1989,Derek Smith,SG,27,TOT,65,38,1295,216,496,.435,7,31,.226,209,465,.449,.443,129,188,.686,61,106,167,128,43,23,88,164,568
1989,Derek Smith,SG,27,SAC,29,20,600,111,276,.402,3,15,.200,108,261,.414,.408,64,95,.674,30,51,81,60,19,8,44,64,289
1989,Derek Smith,SG,27,PHI,36,18,695,105,220,.477,4,16,.250,101,204,.495,.486,65,93,.699,31,55,86,68,24,15,44,100,279
1989,Kenny Smith,PG,23,SAC,81,81,3145,547,1183,.462,46,128,.359,501,1055,.475,.482,263,357,.737,49,177,226,621,102,7,249,173,1403
1989,Larry Smith,PF,31,GSW,80,78,1897,219,397,.552,0,0,,219,397,.552,.552,18,58,.310,272,380,652,118,61,54,110,248,456
1989,Otis Smith,SG,25,GSW,80,5,1597,311,715,.435,7,37,.189,304,678,.448,.440,174,218,.798,128,202,330,140,88,40,129,165,803
1989,Rik Smits,C,22,IND,82,71,2041,386,746,.517,0,1,.000,386,745,.518,.517,184,255,.722,185,315,500,70,37,151,130,310,956
1989,Mike Smrek,PF,26,SAS,43,18,623,72,153,.471,0,0,,72,153,.471,.471,49,76,.645,42,87,129,12,13,58,48,102,193
1989,Rory Sparrow,PG,30,MIA,80,79,2613,444,982,.452,18,74,.243,426,908,.469,.461,94,107,.879,55,161,216,429,103,17,204,168,1000
1989,John Starks,SG,23,GSW,36,0,316,51,125,.408,10,26,.385,41,99,.414,.448,34,52,.654,15,26,41,27,23,3,39,36,146
1989,Everette Stephens,PG,22,IND,35,0,209,23,72,.319,2,10,.200,21,62,.339,.333,17,22,.773,11,12,23,37,9,4,29,22,65
1989,Brook Steppe,PG,29,POR,27,2,244,33,78,.423,5,9,.556,28,69,.406,.455,32,37,.865,13,19,32,16,11,1,13,32,103
1989,John Stockton*,PG,26,UTA,82,82,3171,497,923,.538,16,66,.242,481,857,.561,.547,390,452,.863,83,165,248,1118,263,14,308,241,1400
1989,Rod Strickland,PG,22,NYK,81,10,1358,265,567,.467,19,59,.322,246,508,.484,.484,172,231,.745,51,109,160,319,98,3,148,142,721
1989,John Stroeder,PF,30,TOT,5,0,22,2,5,.400,0,0,,2,5,.400,.400,0,0,,5,9,14,3,0,2,3,3,4
1989,John Stroeder,PF,30,SAS,1,0,2,0,0,,0,0,,0,0,,,0,0,,0,0,0,0,0,0,1,2,0
1989,John Stroeder,PF,30,GSW,4,0,20,2,5,.400,0,0,,2,5,.400,.400,0,0,,5,9,14,3,0,2,2,1,4
1989,Barry Sumpter,PF,23,LAC,1,0,1,0,1,.000,0,0,,0,1,.000,.000,0,0,,0,0,0,0,0,0,0,0,0
1989,Jon Sundvold,SG,27,MIA,68,8,1338,307,675,.455,48,92,.522,259,583,.444,.490,47,57,.825,18,69,87,137,27,1,87,78,709
1989,Roy Tarpley,PF,24,DAL,19,6,591,131,242,.541,0,1,.000,131,241,.544,.541,66,96,.688,77,141,218,17,28,30,45,70,328
1989,Anthony Taylor,PG,23,MIA,21,7,368,60,151,.397,0,2,.000,60,149,.403,.397,24,32,.750,11,23,34,43,22,5,20,37,144
1989,Terry Teagle,SF,28,GSW,66,41,1569,409,859,.476,2,12,.167,407,847,.481,.477,182,225,.809,110,153,263,96,79,17,116,173,1002
1989,Reggie Theus,SG,31,ATL,82,82,2517,497,1067,.466,17,58,.293,480,1009,.476,.474,285,335,.851,86,156,242,387,108,16,194,236,1296
1989,Isiah Thomas*,PG,27,DET,80,76,2924,569,1227,.464,33,121,.273,536,1106,.485,.477,287,351,.818,49,224,273,663,133,20,298,209,1458
1989,Bernard Thompson,PF,26,HOU,23,0,222,20,59,.339,0,2,.000,20,57,.351,.339,22,26,.846,9,19,28,13,13,1,19,33,62
1989,Billy Thompson,SF,25,MIA,79,58,2273,349,716,.487,0,4,.000,349,712,.490,.487,156,224,.696,241,331,572,176,56,105,189,260,854
1989,LaSalle Thompson,C,27,TOT,76,71,2329,416,850,.489,0,1,.000,416,849,.490,.489,227,281,.808,224,494,718,81,79,94,179,285,1059
1989,LaSalle Thompson,C,27,SAC,43,42,1276,247,536,.461,0,1,.000,247,535,.462,.461,152,188,.809,120,272,392,44,46,55,117,153,646
1989,LaSalle Thompson,C,27,IND,33,29,1053,169,314,.538,0,0,,169,314,.538,.538,75,93,.806,104,222,326,37,33,39,62,132,413
1989,Mychal Thompson,C,34,LAL,80,8,1994,291,521,.559,0,1,.000,291,520,.560,.559,156,230,.678,157,310,467,48,58,59,97,224,738
1989,Bob Thornton,PF,26,PHI,54,0,449,47,111,.423,1,3,.333,46,108,.426,.428,32,60,.533,36,56,92,15,8,7,23,87,127
1989,Otis Thorpe,PF,26,HOU,82,82,3135,521,961,.542,0,2,.000,521,959,.543,.542,328,450,.729,272,515,787,202,82,37,225,259,1370
1989,Sedale Threatt,PG,27,SEA,63,0,1220,235,476,.494,11,30,.367,224,446,.502,.505,63,77,.818,31,86,117,238,83,4,77,155,544
1989,Wayman Tisdale,PF,24,TOT,79,35,2434,532,1036,.514,0,4,.000,532,1032,.516,.514,317,410,.773,187,422,609,128,55,52,172,290,1381
1989,Wayman Tisdale,PF,24,IND,48,5,1326,285,564,.505,0,4,.000,285,560,.509,.505,198,250,.792,99,211,310,75,35,32,107,181,768
1989,Wayman Tisdale,PF,24,SAC,31,30,1108,247,472,.523,0,0,,247,472,.523,.523,119,160,.744,88,211,299,53,20,20,65,109,613
1989,Ray Tolbert,PF,30,ATL,50,0,341,40,94,.426,0,0,,40,94,.426,.426,23,37,.622,31,57,88,16,13,13,35,55,103
1989,Tom Tolbert,SF,23,CHH,14,0,117,17,37,.459,0,3,.000,17,34,.500,.459,6,12,.500,7,14,21,7,2,4,2,20,40
1989,Sedric Toney,PG,26,IND,2,0,9,1,5,.200,0,3,.000,1,2,.500,.200,0,1,.000,1,1,2,0,0,0,2,1,2
1989,Kelly Tripucka,SF,29,CHH,71,65,2302,568,1215,.467,30,84,.357,538,1131,.476,.480,440,508,.866,79,188,267,224,88,16,236,196,1606
1989,Trent Tucker,SG,29,NYK,81,24,1824,263,579,.454,118,296,.399,145,283,.512,.556,43,55,.782,55,121,176,132,88,6,59,163,687
1989,Andre Turner,PG,24,MIL,4,0,13,3,6,.500,0,0,,3,6,.500,.500,0,0,,0,3,3,0,2,0,4,2,6
1989,Elston Turner,SF,29,DEN,78,12,1746,151,353,.428,2,7,.286,149,346,.431,.431,33,56,.589,109,178,287,144,90,8,60,209,337
1989,Terry Tyler,SF,32,DAL,70,11,1057,169,360,.469,1,9,.111,168,351,.479,.471,47,62,.758,74,135,209,40,24,39,51,90,386
1989,Kelvin Upshaw,SG,26,TOT,32,0,617,99,212,.467,3,15,.200,96,197,.487,.474,18,26,.692,10,39,49,117,26,3,55,80,219
1989,Kelvin Upshaw,SG,26,MIA,9,0,144,26,63,.413,1,5,.200,25,58,.431,.421,4,6,.667,4,9,13,20,7,0,13,18,57
1989,Kelvin Upshaw,SG,26,BOS,23,0,473,73,149,.490,2,10,.200,71,139,.511,.497,14,20,.700,6,30,36,97,19,3,42,62,162
1989,Darnell Valentine,SG,29,CLE,77,4,1086,136,319,.426,3,14,.214,133,305,.436,.431,91,112,.813,22,81,103,174,57,7,83,88,366
1989,Kiki Vandeweghe,PF,30,TOT,45,1,934,200,426,.469,19,48,.396,181,378,.479,.492,80,89,.899,26,45,71,69,19,11,41,78,499
1989,Kiki Vandeweghe,PF,30,POR,18,1,432,103,217,.475,16,38,.421,87,179,.486,.512,29,33,.879,11,24,35,34,7,4,18,40,251
1989,Kiki Vandeweghe,PF,30,NYK,27,0,502,97,209,.464,3,10,.300,94,199,.472,.471,51,56,.911,15,21,36,35,12,7,23,38,248
1989,Jay Vincent,SF,29,TOT,29,4,646,104,257,.405,1,3,.333,103,254,.406,.407,40,60,.667,38,72,110,27,6,4,42,63,249
1989,Jay Vincent,SF,29,DEN,5,1,95,13,38,.342,1,2,.500,12,36,.333,.355,5,9,.556,2,16,18,5,1,1,5,11,32
1989,Jay Vincent,SF,29,SAS,24,3,551,91,219,.416,0,1,.000,91,218,.417,.416,35,51,.686,36,56,92,22,5,3,37,52,217
1989,Sam Vincent,PG,25,CHI,70,56,1703,274,566,.484,2,17,.118,272,549,.495,.486,106,129,.822,34,156,190,335,53,10,142,124,656
1989,Darrell Walker,PG,27,WSB,79,78,2565,286,681,.420,0,9,.000,286,672,.426,.420,142,184,.772,135,372,507,496,155,23,184,215,714
1989,Kenny Walker,SF,24,NYK,79,2,1163,174,356,.489,5,20,.250,169,336,.503,.496,66,85,.776,101,129,230,36,41,45,44,190,419
1989,Pearl Washington,PG,25,MIA,54,8,1065,164,387,.424,1,14,.071,163,373,.437,.425,82,104,.788,49,74,123,226,73,4,122,101,411
1989,Spud Webb,PG,25,ATL,81,6,1219,133,290,.459,1,22,.045,132,268,.493,.460,52,60,.867,21,102,123,284,70,6,83,104,319
1989,Chris Welp,C,25,PHI,72,0,843,99,222,.446,0,1,.000,99,221,.448,.446,48,73,.658,59,134,193,29,23,41,42,176,246
1989,Bill Wennington,C,25,DAL,65,9,1074,119,275,.433,1,9,.111,118,266,.444,.435,61,82,.744,82,204,286,46,16,35,54,211,300
1989,Mark West,C,28,PHO,82,32,2019,243,372,.653,0,0,,243,372,.653,.653,108,202,.535,167,384,551,39,35,187,103,273,594
1989,Ennis Whatley,PG,26,LAC,8,0,90,12,33,.364,0,0,,12,33,.364,.364,10,11,.909,2,14,16,22,7,1,11,15,34
1989,Clinton Wheeler,PG,29,TOT,28,0,354,45,87,.517,0,1,.000,45,86,.523,.517,15,20,.750,17,14,31,54,27,0,24,26,105
1989,Clinton Wheeler,PG,29,MIA,8,0,143,24,42,.571,0,0,,24,42,.571,.571,8,10,.800,5,7,12,21,8,0,6,9,56
1989,Clinton Wheeler,PG,29,POR,20,0,211,21,45,.467,0,1,.000,21,44,.477,.467,7,10,.700,12,7,19,33,19,0,18,17,49
1989,Eric White,SF,23,TOT,38,0,436,62,120,.517,0,0,,62,120,.517,.517,34,42,.810,34,36,70,17,10,1,26,40,158
1989,Eric White,SF,23,UTA,1,0,2,0,1,.000,0,0,,0,1,.000,.000,0,0,,0,0,0,0,0,0,0,1,0
1989,Eric White,SF,23,LAC,37,0,434,62,119,.521,0,0,,62,119,.521,.521,34,42,.810,34,36,70,17,10,1,26,39,158
1989,Jerome Whitehead,C,32,TOT,57,4,622,72,182,.396,0,0,,72,182,.396,.396,31,47,.660,49,85,134,19,23,4,24,115,175
1989,Jerome Whitehead,C,32,GSW,5,0,42,3,6,.500,0,0,,3,6,.500,.500,1,2,.500,0,5,5,2,1,0,2,8,7
1989,Jerome Whitehead,C,32,SAS,52,4,580,69,176,.392,0,0,,69,176,.392,.392,30,45,.667,49,80,129,17,22,4,22,107,168
1989,Morlon Wiley,PG,22,DAL,51,1,408,46,114,.404,6,24,.250,40,90,.444,.430,13,16,.813,13,34,47,76,25,6,34,61,111
1989,Dominique Wilkins*,SF,29,ATL,80,80,2997,814,1756,.464,29,105,.276,785,1651,.475,.472,442,524,.844,256,297,553,211,117,52,181,138,2099
1989,Eddie Lee Wilkins,C,26,NYK,71,2,584,114,245,.465,0,1,.000,114,244,.467,.465,61,111,.550,72,76,148,7,10,16,56,110,289
1989,Gerald Wilkins,SG,25,NYK,81,58,2414,462,1025,.451,51,172,.297,411,853,.482,.476,186,246,.756,95,149,244,274,115,22,169,166,1161
1989,Buck Williams,PF,28,NJN,74,72,2446,373,702,.531,0,3,.000,373,699,.534,.531,213,320,.666,249,447,696,78,61,36,142,223,959
1989,Herb Williams,C,30,TOT,76,66,2470,322,739,.436,0,5,.000,322,734,.439,.436,133,194,.686,135,458,593,124,46,134,149,236,777
1989,Herb Williams,C,30,IND,46,46,1567,244,542,.450,0,3,.000,244,539,.453,.450,90,126,.714,87,309,396,88,31,80,108,156,578
1989,Herb Williams,C,30,DAL,30,20,903,78,197,.396,0,2,.000,78,195,.400,.396,43,68,.632,48,149,197,36,15,54,41,80,199
1989,Hot Rod Williams,PF,26,CLE,82,10,2125,356,700,.509,1,4,.250,355,696,.510,.509,235,314,.748,173,304,477,108,77,134,102,188,948
1989,John Williams,SF,22,WSB,82,1,2413,438,940,.466,19,71,.268,419,869,.482,.476,225,290,.776,158,415,573,356,142,70,157,213,1120
1989,Kevin Williams,SG,27,TOT,50,0,547,81,200,.405,1,6,.167,80,194,.412,.408,46,59,.780,28,42,70,53,30,11,52,91,209
1989,Kevin Williams,SG,27,NJN,41,0,433,67,168,.399,1,6,.167,66,162,.407,.402,40,51,.784,19,31,50,36,25,8,42,74,175
1989,Kevin Williams,SG,27,LAC,9,0,114,14,32,.438,0,0,,14,32,.438,.438,6,8,.750,9,11,20,17,5,3,10,17,34
1989,Micheal Williams,PG,22,DET,49,0,358,47,129,.364,2,9,.222,45,120,.375,.372,31,47,.660,9,18,27,70,13,3,42,44,127
1989,Reggie Williams,SF,24,LAC,63,17,1303,260,594,.438,30,104,.288,230,490,.469,.463,92,122,.754,70,109,179,103,81,29,114,181,642
1989,David Wingate,SG,25,PHI,33,6,372,54,115,.470,2,6,.333,52,109,.477,.478,27,34,.794,12,25,37,73,9,2,35,43,137
1989,Randy Wittman,SF,29,TOT,64,13,1120,130,286,.455,3,6,.500,127,280,.454,.460,28,41,.683,26,54,80,111,23,2,32,43,291
1989,Randy Wittman,SF,29,SAC,31,2,416,50,117,.427,2,4,.500,48,113,.425,.436,16,22,.727,6,20,26,32,10,0,12,12,118
1989,Randy Wittman,SF,29,IND,33,11,704,80,169,.473,1,2,.500,79,167,.473,.476,12,19,.632,20,34,54,79,13,2,20,31,173
1989,Joe Wolf,C,24,LAC,66,15,1450,170,402,.423,2,14,.143,168,388,.433,.425,44,64,.688,83,188,271,113,32,16,94,152,386
1989,David Wood,PF,24,CHI,2,0,2,0,0,,0,0,,0,0,,,0,0,,0,0,0,0,0,0,0,0,0
1989,Mike Woodson,SG,30,HOU,81,79,2259,410,936,.438,31,89,.348,379,847,.447,.455,195,237,.823,51,143,194,206,89,18,136,195,1046
1989,Orlando Woolridge,SF,29,LAL,74,0,1491,231,494,.468,0,1,.000,231,493,.469,.468,253,343,.738,81,189,270,58,30,65,103,130,715
1989,James Worthy*,SF,27,LAL,81,81,2960,702,1282,.548,2,23,.087,700,1259,.556,.548,251,321,.782,169,320,489,288,108,56,182,175,1657
1989,Danny Young,PG,26,POR,48,2,952,115,250,.460,17,50,.340,98,200,.490,.494,50,64,.781,17,57,74,123,55,3,45,50,297
1990,Mark Acres,C,27,ORL,80,50,1691,138,285,.484,3,4,.750,135,281,.480,.489,83,120,.692,154,277,431,67,36,25,70,248,362
1990,Michael Adams,PG,27,DEN,79,74,2690,398,989,.402,158,432,.366,240,557,.431,.482,267,314,.850,49,176,225,495,121,3,141,133,1221
1990,Mark Aguirre,SF,30,DET,78,40,2005,438,898,.488,31,93,.333,407,805,.506,.505,192,254,.756,117,188,305,145,34,19,121,201,1099
1990,Danny Ainge,PG,30,SAC,75,68,2727,506,1154,.438,108,289,.374,398,865,.460,.485,222,267,.831,69,257,326,453,113,18,185,238,1342
1990,Mark Alarie,PF,26,WSB,82,10,1893,371,785,.473,10,49,.204,361,736,.490,.479,108,133,.812,151,223,374,142,60,39,101,219,860
1990,Steve Alford,PG,25,DAL,41,0,302,63,138,.457,7,22,.318,56,116,.483,.482,35,37,.946,2,23,25,39,15,3,16,22,168
1990,Randy Allen,SG,25,SAC,63,6,746,106,239,.444,0,7,.000,106,232,.457,.444,23,43,.535,49,89,138,23,16,19,28,102,235
1990,Greg Anderson,PF,25,MIL,60,28,1291,219,432,.507,0,0,,219,432,.507,.507,91,170,.535,112,261,373,24,32,54,80,176,529
1990,Nick Anderson,SG,22,ORL,81,9,1785,372,753,.494,1,17,.059,371,736,.504,.495,186,264,.705,107,209,316,124,69,34,138,140,931
1990,Richard Anderson,PF,29,CHH,54,2,604,88,211,.417,37,100,.370,51,111,.459,.505,18,23,.783,33,94,127,55,20,9,26,64,231
1990,Ron Anderson,SF,31,PHI,78,3,2089,379,841,.451,3,21,.143,376,820,.459,.452,165,197,.838,81,214,295,143,72,13,78,143,926
1990,Willie Anderson,SG,23,SAS,82,81,2788,532,1082,.492,7,26,.269,525,1056,.497,.495,217,290,.748,115,257,372,364,111,58,198,252,1288
1990,Michael Ansley,SF,22,ORL,72,5,1221,231,465,.497,0,0,,231,465,.497,.497,164,227,.722,187,175,362,40,24,17,50,152,626
1990,B.J. Armstrong,PG,22,CHI,81,0,1291,190,392,.485,3,6,.500,187,386,.484,.489,69,78,.885,19,83,102,199,46,6,83,105,452
1990,John Bagley,PG,29,BOS,54,17,1095,100,218,.459,1,18,.056,99,200,.495,.461,29,39,.744,26,63,89,296,40,4,90,77,230
1990,Thurl Bailey,SF,28,UTA,82,33,2583,470,977,.481,0,8,.000,470,969,.485,.481,222,285,.779,116,294,410,137,32,100,139,175,1162
1990,Ken Bannister,PF,29,LAC,52,1,589,77,161,.478,0,1,.000,77,160,.481,.478,52,110,.473,39,73,112,18,17,7,44,92,206
1990,Charles Barkley*,SF,26,PHI,79,79,3085,706,1177,.600,20,92,.217,686,1085,.632,.608,557,744,.749,361,548,909,307,148,50,243,250,1989
1990,Dana Barros,PG,22,SEA,81,25,1630,299,738,.405,95,238,.399,204,500,.408,.470,89,110,.809,35,97,132,205,53,1,123,97,782
1990,John Battle,SG,27,ATL,60,48,1477,275,544,.506,2,13,.154,273,531,.514,.507,102,135,.756,27,72,99,154,28,3,89,115,654
1990,Kenny Battle,SG,25,PHO,59,8,729,93,170,.547,1,4,.250,92,166,.554,.550,55,82,.671,44,80,124,38,35,11,32,94,242
1990,William Bedford,C,26,DET,42,0,246,54,125,.432,1,6,.167,53,119,.445,.436,9,22,.409,15,43,58,4,3,17,21,39,118
1990,Benoit Benjamin,C,25,LAC,71,58,2313,362,688,.526,0,1,.000,362,687,.527,.526,235,321,.732,156,501,657,159,59,187,187,217,959
1990,Winston Bennett,SF,24,CLE,55,34,990,137,286,.479,0,0,,137,286,.479,.479,64,96,.667,84,104,188,54,23,10,62,133,338
1990,Larry Bird*,SF,33,BOS,75,75,2944,718,1517,.473,65,195,.333,653,1322,.494,.495,319,343,.930,90,622,712,562,106,61,243,173,1820
1990,Uwe Blab,C,27,TOT,47,33,531,39,98,.398,0,0,,39,98,.398,.398,20,37,.541,29,79,108,25,1,22,35,102,98
1990,Uwe Blab,C,27,GSW,40,33,481,33,87,.379,0,0,,33,87,.379,.379,17,31,.548,28,71,99,24,1,22,30,93,83
1990,Uwe Blab,C,27,SAS,7,0,50,6,11,.545,0,0,,6,11,.545,.545,3,6,.500,1,8,9,1,0,0,5,9,15
1990,Rolando Blackman,SG,30,DAL,80,80,2934,626,1256,.498,13,43,.302,613,1213,.505,.504,287,340,.844,88,192,280,289,77,21,174,128,1552
1990,Mookie Blaylock,PG,22,NJN,50,17,1267,212,571,.371,18,80,.225,194,491,.395,.387,63,81,.778,42,98,140,210,82,14,111,110,505
1990,Muggsy Bogues,PG,25,CHH,81,65,2743,326,664,.491,5,26,.192,321,638,.503,.495,106,134,.791,48,159,207,867,166,3,146,168,763
1990,Manute Bol,C,27,GSW,75,20,1310,56,169,.331,9,48,.188,47,121,.388,.358,25,49,.510,33,243,276,36,13,238,51,194,146
1990,Anthony Bowie,SG,26,HOU,66,0,918,119,293,.406,6,21,.286,113,272,.415,.416,40,54,.741,36,82,118,96,42,5,59,80,284
1990,Sam Bowie,C,28,NJN,68,54,2207,347,834,.416,10,31,.323,337,803,.420,.422,294,379,.776,206,484,690,91,38,121,125,211,998
1990,Adrian Branch,SF,26,MIN,11,0,91,25,61,.410,1,1,1.000,24,60,.400,.418,14,22,.636,8,12,20,4,6,0,8,14,65
1990,Randy Breuer,C,29,TOT,81,55,1879,298,696,.428,0,1,.000,298,695,.429,.428,126,193,.653,154,263,417,97,42,108,96,196,722
1990,Randy Breuer,C,29,MIL,30,8,554,86,186,.462,0,0,,86,186,.462,.462,32,51,.627,43,84,127,13,9,33,28,63,204
1990,Randy Breuer,C,29,MIN,51,47,1325,212,510,.416,0,1,.000,212,509,.417,.416,94,142,.662,111,179,290,84,33,75,68,133,518
1990,Frank Brickowski,C,30,SAS,78,12,1438,211,387,.545,0,2,.000,211,385,.548,.545,95,141,.674,89,238,327,105,66,37,93,226,517
1990,Scott Brooks,PG,24,PHI,72,1,975,119,276,.431,31,79,.392,88,197,.447,.487,50,57,.877,15,49,64,207,47,0,38,105,319
1990,Chucky Brown,SF,21,CLE,75,35,1339,210,447,.470,0,7,.000,210,440,.477,.470,125,164,.762,83,148,231,50,33,26,69,148,545
1990,Mike Brown,C,26,UTA,82,0,1397,177,344,.515,1,2,.500,176,342,.515,.516,157,199,.789,111,262,373,47,32,28,88,187,512
1990,Raymond Brown,PF,24,UTA,16,0,56,8,28,.286,0,0,,8,28,.286,.286,0,2,.000,10,5,15,4,0,0,6,11,16
1990,Tony Brown,SF,29,MIL,61,10,635,88,206,.427,5,20,.250,83,186,.446,.439,38,56,.679,39,33,72,41,32,4,51,79,219
1990,Stanley Brundy,SF,22,NJN,16,0,128,15,30,.500,0,0,,15,30,.500,.500,7,18,.389,15,11,26,3,6,5,6,24,37
1990,Mark Bryant,PF,24,POR,58,0,562,70,153,.458,0,0,,70,153,.458,.458,28,50,.560,54,92,146,13,18,9,25,93,168
1990,Torgeir Bryn,C,25,LAC,3,0,10,0,2,.000,0,0,,0,2,.000,.000,4,6,.667,0,2,2,0,2,1,1,5,4
1990,Steve Bucknall,SG,23,LAL,18,0,75,9,33,.273,0,1,.000,9,32,.281,.273,5,6,.833,5,2,7,10,2,1,11,10,23
1990,Greg Butler,C,23,NYK,13,0,33,3,12,.250,0,0,,3,12,.250,.250,0,2,.000,3,6,9,1,0,0,3,8,6
1990,Michael Cage,C,28,SEA,82,82,2595,325,645,.504,0,0,,325,645,.504,.504,148,212,.698,306,515,821,70,79,45,94,232,798
1990,Adrian Caldwell,PF,23,HOU,51,0,331,42,76,.553,0,0,,42,76,.553,.553,13,28,.464,36,73,109,7,11,18,32,69,97
1990,Tony Campbell,SG,27,MIN,82,81,3164,723,1581,.457,9,54,.167,714,1527,.468,.460,448,569,.787,209,242,451,213,111,31,251,260,1903
1990,Rick Carlisle,SG,30,NJN,5,0,21,1,7,.143,0,3,.000,1,4,.250,.143,0,0,,0,0,0,5,1,1,4,7,2
1990,Antoine Carr,PF,28,TOT,77,4,1727,356,721,.494,0,7,.000,356,714,.499,.494,237,298,.795,115,207,322,119,30,68,125,247,949
1990,Antoine Carr,PF,28,ATL,44,0,803,128,248,.516,0,4,.000,128,244,.525,.516,79,102,.775,50,99,149,53,15,34,54,128,335
1990,Antoine Carr,PF,28,SAC,33,4,924,228,473,.482,0,3,.000,228,470,.485,.482,158,196,.806,65,108,173,66,15,34,71,119,614
1990,Joe Barry Carroll,C,31,TOT,76,47,1721,312,759,.411,0,2,.000,312,757,.412,.411,137,177,.774,133,310,443,97,47,115,142,192,761
1990,Joe Barry Carroll,C,31,NJN,46,20,1002,159,405,.393,0,2,.000,159,403,.395,.393,85,107,.794,82,168,250,43,19,56,64,122,403
1990,Joe Barry Carroll,C,31,DEN,30,27,719,153,354,.432,0,0,,153,354,.432,.432,52,70,.743,51,142,193,54,28,59,78,70,358
1990,Bill Cartwright,C,32,CHI,71,71,2160,292,598,.488,0,0,,292,598,.488,.488,227,280,.811,137,328,465,145,38,34,123,243,811
1990,Terry Catledge,PF,26,ORL,74,72,2462,546,1152,.474,2,8,.250,544,1144,.476,.475,341,486,.702,271,292,563,72,36,17,181,201,1435
1990,Tom Chambers,PF,30,PHO,81,81,3046,810,1617,.501,24,86,.279,786,1531,.513,.508,557,647,.861,121,450,571,190,88,47,218,260,2201
1990,Rex Chapman,SG,22,CHH,54,52,1762,377,924,.408,47,142,.331,330,782,.422,.433,144,192,.750,52,127,179,132,46,6,100,113,945
1990,Maurice Cheeks*,PG,33,TOT,81,62,2519,307,609,.504,4,16,.250,303,593,.511,.507,171,202,.847,50,190,240,453,124,10,121,78,789
1990,Maurice Cheeks*,PG,33,SAS,50,49,1766,215,450,.478,1,9,.111,214,441,.485,.479,114,137,.832,39,128,167,302,82,5,85,46,545
1990,Maurice Cheeks*,PG,33,NYK,31,13,753,92,159,.579,3,7,.429,89,152,.586,.588,57,65,.877,11,62,73,151,42,5,36,32,244
1990,Derrick Chievous,SF,22,TOT,55,0,591,105,220,.477,3,9,.333,102,211,.483,.484,80,111,.721,35,55,90,31,26,5,45,70,293
1990,Derrick Chievous,SF,22,HOU,41,0,492,90,178,.506,3,8,.375,87,170,.512,.514,61,87,.701,28,47,75,27,23,4,40,59,244
1990,Derrick Chievous,SF,22,CLE,14,0,99,15,42,.357,0,1,.000,15,41,.366,.357,19,24,.792,7,8,15,4,3,1,5,11,49
1990,Ben Coleman,PF,28,MIL,22,0,305,46,97,.474,0,1,.000,46,96,.479,.474,34,41,.829,31,56,87,12,7,7,26,54,126
1990,Steve Colter,PG,27,WSB,73,1,977,142,297,.478,0,5,.000,142,292,.486,.478,77,95,.811,55,121,176,148,47,10,38,98,361
1990,Lester Conner,PG,30,NJN,82,61,2355,237,573,.414,2,13,.154,235,560,.420,.415,172,214,.804,90,175,265,385,172,8,138,182,648
1990,Michael Cooper,SG,33,LAL,80,10,1851,191,493,.387,50,157,.318,141,336,.420,.438,83,94,.883,59,168,227,215,67,36,91,206,515
1990,Wayne Cooper,C,33,POR,79,0,1176,138,304,.454,0,3,.000,138,301,.458,.454,25,39,.641,118,221,339,44,18,95,39,211,301
1990,Lanard Copeland,SG,24,PHI,23,0,110,31,68,.456,1,5,.200,30,63,.476,.463,11,14,.786,4,6,10,9,1,1,19,12,74
1990,Tyrone Corbin,SF,27,MIN,82,80,3011,521,1083,.481,0,11,.000,521,1072,.486,.481,161,209,.770,219,385,604,216,175,41,143,288,1203
1990,Dave Corzine,C,33,ORL,6,3,79,11,29,.379,0,0,,11,29,.379,.379,0,2,.000,7,11,18,2,2,0,8,7,22
1990,Pat Cummings,C,33,MIA,37,1,391,77,159,.484,0,0,,77,159,.484,.484,21,37,.568,28,65,93,13,12,4,32,60,175
1990,Terry Cummings,PF,28,SAS,81,78,2821,728,1532,.475,19,59,.322,709,1473,.481,.481,343,440,.780,226,451,677,219,110,52,202,286,1818
1990,Dell Curry,SG,25,CHH,67,13,1860,461,990,.466,52,147,.354,409,843,.485,.492,96,104,.923,31,137,168,159,98,26,100,148,1070
1990,Quintin Dailey,SG,29,SEA,30,2,491,97,240,.404,1,5,.200,96,235,.409,.406,52,66,.788,18,33,51,34,12,0,34,63,247
1990,Adrian Dantley*,SF,34,DAL,45,45,1300,231,484,.477,0,2,.000,231,482,.479,.477,200,254,.787,78,94,172,80,20,7,75,99,662
1990,Brad Daugherty,C,24,CLE,41,40,1438,244,509,.479,0,2,.000,244,507,.481,.479,202,287,.704,77,296,373,130,29,22,110,108,690
1990,Brad Davis,PG,34,DAL,73,2,1292,179,365,.490,35,104,.337,144,261,.552,.538,77,100,.770,12,81,93,242,47,9,86,151,470
1990,Charles Davis,SF,31,CHI,53,0,429,58,158,.367,7,25,.280,51,133,.383,.389,7,8,.875,25,56,81,18,10,8,20,52,130
1990,Terry Davis,PF,22,MIA,63,9,884,122,262,.466,0,1,.000,122,261,.467,.466,54,87,.621,93,136,229,25,25,28,68,171,298
1990,Walter Davis,SG,35,DEN,69,0,1635,497,1033,.481,6,46,.130,491,987,.497,.484,207,227,.912,46,133,179,155,59,9,102,160,1207
1990,Johnny Dawkins,PG,26,PHI,81,81,2865,465,950,.489,22,66,.333,443,884,.501,.501,210,244,.861,48,199,247,601,121,9,214,159,1162
1990,Vinny Del Negro,SG,23,SAC,76,29,1858,297,643,.462,10,32,.313,287,611,.470,.470,135,155,.871,39,159,198,250,64,10,111,182,739
1990,Byron Dinkins,PG,22,HOU,33,0,362,44,109,.404,1,9,.111,43,100,.430,.408,26,30,.867,13,27,40,75,19,2,37,30,115
1990,Vlade Divac*,C,21,LAL,82,5,1611,274,549,.499,0,5,.000,274,544,.504,.499,153,216,.708,167,345,512,75,79,114,110,240,701
1990,James Donaldson,C,32,DAL,73,73,2265,258,479,.539,0,0,,258,479,.539,.539,149,213,.700,155,475,630,57,22,47,119,129,665
1990,Sherman Douglas,PG,23,MIA,81,66,2470,463,938,.494,5,31,.161,458,907,.505,.496,224,326,.687,70,136,206,619,145,10,246,187,1155
1990,Terry Dozier,SF,23,CHH,9,0,92,9,27,.333,0,1,.000,9,26,.346,.333,4,8,.500,7,8,15,3,6,2,7,10,22
1990,Greg Dreiling,C,27,IND,49,0,307,20,53,.377,0,0,,20,53,.377,.377,25,34,.735,21,66,87,8,4,14,19,69,65
1990,Larry Drew,PG,31,LAL,80,3,1333,170,383,.444,32,81,.395,138,302,.457,.486,46,60,.767,12,86,98,217,47,4,95,92,418
1990,Clyde Drexler*,SG,27,POR,73,73,2683,670,1357,.494,30,106,.283,640,1251,.512,.505,333,430,.774,208,299,507,432,145,51,191,222,1703
1990,Kevin Duckworth,C,25,POR,82,82,2462,548,1146,.478,0,0,,548,1146,.478,.478,231,312,.740,184,325,509,91,36,34,171,271,1327
1990,Chris Dudley,PF,24,TOT,64,30,1356,146,355,.411,0,0,,146,355,.411,.411,58,182,.319,174,249,423,39,41,72,84,164,350
1990,Chris Dudley,PF,24,CLE,37,22,684,79,203,.389,0,0,,79,203,.389,.389,26,77,.338,88,115,203,20,19,41,48,83,184
1990,Chris Dudley,PF,24,NJN,27,8,672,67,152,.441,0,0,,67,152,.441,.441,32,105,.305,86,134,220,19,22,31,36,81,166
1990,Joe Dumars*,SG,26,DET,75,71,2578,508,1058,.480,22,55,.400,486,1003,.485,.491,297,330,.900,60,152,212,368,63,2,145,129,1335
1990,Mike Dunleavy,PG,35,MIL,5,0,43,4,14,.286,2,9,.222,2,5,.400,.357,7,8,.875,0,2,2,10,1,0,8,7,17
1990,T.R. Dunn,SF,34,DEN,65,2,657,44,97,.454,0,2,.000,44,95,.463,.454,26,39,.667,56,82,138,43,41,4,19,67,114
1990,Ledell Eackles,SG,23,WSB,78,8,1696,413,940,.439,19,59,.322,394,881,.447,.449,210,280,.750,74,101,175,182,50,4,143,157,1055
1990,Mark Eaton,C,33,UTA,82,82,2281,158,300,.527,0,0,,158,300,.527,.527,79,118,.669,171,430,601,39,33,201,75,238,395
1990,Blue Edwards,SF,24,UTA,82,49,1889,286,564,.507,9,30,.300,277,534,.519,.515,146,203,.719,69,182,251,145,76,36,152,280,727
1990,James Edwards,C,34,DET,82,70,2283,462,928,.498,0,3,.000,462,925,.499,.498,265,354,.749,112,233,345,63,23,37,133,295,1189
1990,Jay Edwards,SG,21,LAC,4,0,26,3,7,.429,0,2,.000,3,5,.600,.429,1,3,.333,1,1,2,4,1,0,1,4,7
1990,Kevin Edwards,SG,24,MIA,78,54,2211,395,959,.412,9,30,.300,386,929,.416,.417,139,183,.760,77,205,282,252,125,33,180,149,938
1990,Craig Ehlo,SG,28,CLE,81,64,2894,436,940,.464,104,248,.419,332,692,.480,.519,126,185,.681,147,292,439,371,126,23,161,226,1102
1990,Sean Elliott,SF,21,SAS,81,69,2032,311,647,.481,1,9,.111,310,638,.486,.481,187,216,.866,127,170,297,154,45,14,112,172,810
1990,Dale Ellis,SG,29,SEA,55,49,2033,502,1011,.497,96,256,.375,406,755,.538,.544,193,236,.818,90,148,238,110,59,7,119,124,1293
1990,Pervis Ellison,C,22,SAC,34,22,866,111,251,.442,0,2,.000,111,249,.446,.442,49,78,.628,64,132,196,65,16,57,62,132,271
1990,Alex English*,SF,36,DEN,80,80,2211,635,1293,.491,2,5,.400,633,1288,.491,.492,161,183,.880,119,167,286,225,51,23,93,130,1433
1990,Patrick Ewing*,C,27,NYK,82,82,3165,922,1673,.551,1,4,.250,921,1669,.552,.551,502,648,.775,235,658,893,182,78,327,278,325,2347
1990,Jim Farmer,SG,25,SEA,38,0,400,89,203,.438,8,27,.296,81,176,.460,.458,57,80,.713,17,26,43,25,17,1,27,44,243
1990,Duane Ferrell,SF,24,ATL,14,0,29,5,14,.357,0,1,.000,5,13,.385,.357,2,6,.333,3,4,7,2,1,0,2,3,12
1990,Vern Fleming,PG,27,IND,82,82,2876,467,919,.508,12,34,.353,455,885,.514,.515,230,294,.782,118,204,322,610,92,10,206,213,1176
1990,Sleepy Floyd,PG,29,HOU,82,73,2630,362,803,.451,89,234,.380,273,569,.480,.506,187,232,.806,46,152,198,600,94,11,204,159,1000
1990,Tellis Frank,PF,24,MIA,77,39,1762,278,607,.458,0,0,,278,607,.458,.458,179,234,.765,151,234,385,85,51,27,134,282,735
1990,Corey Gaines,SG,24,PHI,9,0,81,4,12,.333,1,2,.500,3,10,.300,.375,1,4,.250,1,4,5,26,4,0,10,11,10
1990,Kevin Gamble,SF,24,BOS,71,10,990,137,301,.455,3,18,.167,134,283,.473,.460,85,107,.794,42,70,112,119,28,8,44,77,362
1990,Winston Garland,PG,25,TOT,79,19,1762,230,573,.401,12,36,.333,218,537,.406,.412,102,122,.836,51,163,214,303,78,10,158,152,574
1990,Winston Garland,PG,25,GSW,51,4,891,108,288,.375,1,10,.100,107,278,.385,.377,53,63,.841,31,80,111,157,48,5,81,77,270
1990,Winston Garland,PG,25,LAC,28,15,871,122,285,.428,11,26,.423,111,259,.429,.447,49,59,.831,20,83,103,146,30,5,77,75,304
1990,Tom Garrick,SG,23,LAC,73,22,1721,208,421,.494,4,21,.190,204,400,.510,.499,88,114,.772,34,128,162,289,90,7,117,151,508
1990,Kenny Gattison,PF,25,CHH,63,2,941,148,269,.550,1,1,1.000,147,268,.549,.552,75,110,.682,75,122,197,39,35,31,67,150,372
1990,Derrick Gervin,PF,26,NJN,21,0,339,93,197,.472,0,3,.000,93,194,.479,.472,65,89,.730,29,36,65,8,20,7,12,47,251
1990,Armen Gilliam,PF,25,TOT,76,66,2426,484,940,.515,0,2,.000,484,938,.516,.515,303,419,.723,211,388,599,99,69,51,183,212,1271
1990,Armen Gilliam,PF,25,PHO,16,7,267,52,121,.430,0,0,,52,121,.430,.430,39,56,.696,26,44,70,8,6,5,17,28,143
1990,Armen Gilliam,PF,25,CHH,60,59,2159,432,819,.527,0,2,.000,432,817,.529,.527,264,363,.727,185,344,529,91,63,46,166,184,1128
1990,Mike Gminski,C,30,PHI,81,81,2659,458,1002,.457,3,17,.176,455,985,.462,.459,193,235,.821,196,491,687,128,43,102,98,136,1112
1990,Gary Grant,PG,24,LAC,44,44,1529,241,517,.466,5,21,.238,236,496,.476,.471,88,113,.779,59,136,195,442,108,5,206,120,575
1990,Greg Grant,PG,23,PHO,67,3,678,83,216,.384,3,16,.188,80,200,.400,.391,39,59,.661,16,43,59,168,36,1,77,58,208
1990,Harvey Grant,PF,24,WSB,81,25,1846,284,601,.473,0,8,.000,284,593,.479,.473,96,137,.701,138,204,342,131,52,43,85,194,664
1990,Horace Grant,PF,24,CHI,80,80,2753,446,853,.523,0,0,,446,853,.523,.523,179,256,.699,236,393,629,227,92,84,110,230,1071
1990,Stuart Gray,C,26,TOT,58,1,560,42,99,.424,0,5,.000,42,94,.447,.424,32,47,.681,40,105,145,19,15,26,24,90,116
1990,Stuart Gray,C,26,CHH,39,1,466,38,82,.463,0,2,.000,38,80,.475,.463,25,39,.641,38,93,131,17,12,24,19,64,101
1990,Stuart Gray,C,26,NYK,19,0,94,4,17,.235,0,3,.000,4,14,.286,.235,7,8,.875,2,12,14,2,3,2,5,26,15
1990,Jeff Grayer,SF,24,MIL,71,40,1427,224,487,.460,1,8,.125,223,479,.466,.461,99,152,.651,94,123,217,107,48,10,82,125,548
1990,A.C. Green,PF,26,LAL,82,82,2709,385,806,.478,13,46,.283,372,760,.489,.486,278,370,.751,262,450,712,90,66,50,116,207,1061
1990,Rickey Green,PG,35,IND,69,0,927,100,231,.433,1,11,.091,99,220,.450,.435,43,51,.843,9,45,54,182,51,1,62,60,244
1990,Sidney Green,C,29,ORL,73,31,1860,312,667,.468,1,3,.333,311,664,.468,.469,136,209,.651,166,422,588,99,50,26,119,231,761
1990,Dave Greenwood,PF,32,DET,37,0,205,22,52,.423,0,0,,22,52,.423,.423,16,29,.552,24,54,78,12,4,9,16,40,60
1990,Darrell Griffith,SG,31,UTA,82,1,1444,301,649,.464,80,215,.372,221,434,.509,.525,51,78,.654,43,123,166,63,68,19,75,149,733
1990,Scott Haffner,PG,23,MIA,43,6,559,88,217,.406,3,21,.143,85,196,.434,.412,17,25,.680,7,44,51,80,13,2,33,53,196
1990,Jack Haley,PF,26,TOT,67,26,1084,138,347,.398,0,1,.000,138,346,.399,.398,85,125,.680,115,185,300,26,18,12,72,170,361
1990,Jack Haley,PF,26,CHI,11,0,58,9,20,.450,0,0,,9,20,.450,.450,7,7,1.000,7,11,18,4,0,1,7,7,25
1990,Jack Haley,PF,26,NJN,56,26,1026,129,327,.394,0,1,.000,129,326,.396,.394,78,118,.661,108,174,282,22,18,11,65,163,336
1990,Tom Hammonds,PF,22,WSB,61,8,805,129,295,.437,0,1,.000,129,294,.439,.437,63,98,.643,61,107,168,51,11,14,46,98,321
1990,Bob Hansen,SG,29,UTA,81,81,2174,265,568,.467,54,154,.351,211,414,.510,.514,33,64,.516,66,163,229,149,52,11,79,194,617
1990,Bill Hanzlik,PF,32,DEN,81,0,1605,179,396,.452,6,31,.194,173,365,.474,.460,136,183,.743,67,140,207,186,78,29,87,249,500
1990,Tim Hardaway*,PG,23,GSW,79,78,2663,464,985,.471,23,84,.274,441,901,.489,.483,211,276,.764,57,253,310,689,165,12,260,232,1162
1990,Derek Harper,PG,28,DAL,82,82,3007,567,1161,.488,89,240,.371,478,921,.519,.527,250,315,.794,54,190,244,609,187,26,207,224,1473
1990,Ron Harper,SG,26,TOT,35,35,1367,301,637,.473,14,51,.275,287,586,.490,.484,182,231,.788,74,132,206,182,81,41,100,105,798
1990,Ron Harper,SG,26,CLE,7,7,262,61,138,.442,1,5,.200,60,133,.451,.446,31,41,.756,19,29,48,49,14,9,18,25,154
1990,Ron Harper,SG,26,LAC,28,28,1105,240,499,.481,13,46,.283,227,453,.501,.494,151,190,.795,55,103,158,133,67,32,82,80,644
1990,Steve Harris,SG,26,LAC,15,0,93,14,40,.350,0,0,,14,40,.350,.350,3,4,.750,5,5,10,1,7,1,5,9,31
1990,Scott Hastings,PF,29,DET,40,0,166,10,33,.303,3,12,.250,7,21,.333,.348,19,22,.864,7,25,32,8,3,3,7,31,42
1990,Hersey Hawkins,SG,23,PHI,82,82,2856,522,1136,.460,84,200,.420,438,936,.468,.496,387,436,.888,85,219,304,261,130,28,185,217,1515
1990,Gerald Henderson,PG,34,TOT,57,0,464,53,109,.486,17,38,.447,36,71,.507,.564,12,15,.800,11,32,43,74,16,2,24,50,135
1990,Gerald Henderson,PG,34,MIL,11,0,129,11,26,.423,3,7,.429,8,19,.421,.481,2,2,1.000,3,9,12,13,8,0,8,14,27
1990,Gerald Henderson,PG,34,DET,46,0,335,42,83,.506,14,31,.452,28,52,.538,.590,10,13,.769,8,23,31,61,8,2,16,36,108
1990,Mike Higgins,SF,22,TOT,11,0,50,3,8,.375,0,0,,3,8,.375,.375,8,10,.800,2,2,4,3,2,2,1,5,14
1990,Mike Higgins,SF,22,LAL,6,0,18,0,0,,0,0,,0,0,,,1,2,.500,1,0,1,1,1,2,0,4,1
1990,Mike Higgins,SF,22,DEN,5,0,32,3,8,.375,0,0,,3,8,.375,.375,7,8,.875,1,2,3,2,1,0,1,1,13
1990,Rod Higgins,PF,30,GSW,82,22,1993,304,632,.481,67,193,.347,237,439,.540,.534,234,285,.821,120,302,422,129,47,53,93,184,909
1990,Roy Hinson,PF,28,NJN,25,19,793,145,286,.507,0,0,,145,286,.507,.507,86,99,.869,61,111,172,22,14,27,52,87,376
1990,Craig Hodges,SG,29,CHI,63,0,1055,145,331,.438,87,181,.481,58,150,.387,.569,30,33,.909,11,42,53,110,30,2,30,87,407
1990,Michael Holton,PG,28,CHH,16,0,109,14,26,.538,0,0,,14,26,.538,.538,1,2,.500,1,1,2,16,1,0,13,19,29
1990,Dave Hoppen,C,25,CHH,10,2,135,16,41,.390,0,0,,16,41,.390,.390,8,10,.800,19,17,36,6,2,1,8,26,40
1990,Dennis Hopson,SG,24,NJN,79,64,2551,474,1093,.434,32,101,.317,442,992,.446,.448,271,342,.792,113,166,279,151,100,51,168,183,1251
1990,Tito Horford,C,24,MIL,35,0,236,18,62,.290,0,0,,18,62,.290,.290,15,24,.625,19,40,59,2,5,16,14,33,51
1990,Jeff Hornacek,SG,26,PHO,67,60,2278,483,901,.536,40,98,.408,443,803,.552,.558,173,202,.856,86,227,313,337,117,14,125,144,1179
1990,Ed Horton,PF,22,WSB,45,10,374,80,162,.494,0,4,.000,80,158,.506,.494,42,69,.609,59,49,108,19,9,5,39,63,202
1990,Eddie Hughes,PG,29,DEN,60,7,892,83,202,.411,20,49,.408,63,153,.412,.460,23,34,.676,15,55,70,116,48,1,39,87,209
1990,Jay Humphries,PG,27,MIL,81,81,2818,496,1005,.494,21,70,.300,475,935,.508,.504,224,285,.786,80,189,269,472,156,11,151,253,1237
1990,Byron Irvin,SG,23,POR,50,2,488,96,203,.473,5,14,.357,91,189,.481,.485,61,91,.670,30,44,74,47,28,1,39,40,258
1990,Jaren Jackson,SG,22,NJN,28,0,160,25,69,.362,0,3,.000,25,66,.379,.362,17,21,.810,16,8,24,13,13,1,18,16,67
1990,Mark Jackson,PG,24,NYK,82,69,2428,327,749,.437,35,131,.267,292,618,.472,.460,120,165,.727,106,212,318,604,109,4,211,121,809
1990,Michael Jackson,PG,25,SAC,17,0,58,3,11,.273,1,2,.500,2,9,.222,.318,3,6,.500,2,5,7,8,5,0,4,3,10
1990,Avery Johnson,PG,24,SEA,53,10,575,55,142,.387,1,4,.250,54,138,.391,.391,29,40,.725,21,22,43,162,26,1,48,55,140
1990,Buck Johnson,SF,26,HOU,82,82,2832,504,1019,.495,2,17,.118,502,1002,.501,.496,205,270,.759,113,268,381,252,104,62,167,321,1215
1990,Dennis Johnson*,PG,35,BOS,75,65,2036,206,475,.434,1,24,.042,205,451,.455,.435,118,140,.843,48,153,201,485,81,14,117,179,531
1990,Eddie Johnson,SF,30,PHO,64,4,1811,411,907,.453,70,184,.380,341,723,.472,.492,188,205,.917,69,177,246,107,32,10,108,174,1080
1990,Eric Johnson,PG,23,UTA,48,2,272,20,84,.238,1,6,.167,19,78,.244,.244,13,17,.765,8,20,28,64,17,2,26,49,54
1990,Kevin Johnson,PG,23,PHO,74,74,2782,578,1159,.499,8,41,.195,570,1118,.510,.502,501,598,.838,42,228,270,846,95,14,263,143,1665
1990,Magic Johnson*,PG,30,LAL,79,79,2937,546,1138,.480,106,276,.384,440,862,.510,.526,567,637,.890,128,394,522,907,132,34,289,167,1765
1990,Marques Johnson,SF,33,GSW,10,0,99,12,32,.375,2,3,.667,10,29,.345,.406,14,17,.824,8,9,17,9,0,1,10,12,40
1990,Steve Johnson,C,32,TOT,25,0,259,48,92,.522,0,0,,48,92,.522,.522,21,35,.600,19,34,53,17,3,5,31,56,117
1990,Steve Johnson,C,32,MIN,4,0,17,0,2,.000,0,0,,0,2,.000,.000,0,0,,0,3,3,1,0,0,6,4,0
1990,Steve Johnson,C,32,SEA,21,0,242,48,90,.533,0,0,,48,90,.533,.533,21,35,.600,19,31,50,16,3,5,25,52,117
1990,Vinnie Johnson,SG,33,DET,82,12,1972,334,775,.431,5,34,.147,329,741,.444,.434,131,196,.668,108,148,256,255,71,13,123,143,804
1990,Nate Johnston,PF-SF,23,TOT,21,0,87,18,48,.375,1,4,.250,17,44,.386,.385,9,13,.692,13,10,23,1,3,8,6,11,46
1990,Nate Johnston,SF,23,UTA,6,0,13,4,11,.364,1,1,1.000,3,10,.300,.409,2,2,1.000,2,0,2,0,0,1,1,0,11
1990,Nate Johnston,PF,23,POR,15,0,74,14,37,.378,0,3,.000,14,34,.412,.378,7,11,.636,11,10,21,1,3,7,5,11,35
1990,Anthony Jones,SG,27,DAL,66,0,650,72,194,.371,4,13,.308,68,181,.376,.381,47,69,.681,33,49,82,29,32,16,42,77,195
1990,Caldwell Jones,PF,39,SAS,72,2,885,67,144,.465,1,5,.200,66,139,.475,.469,38,54,.704,76,154,230,20,20,27,48,146,173
1990,Charles Jones,C,32,WSB,81,81,2240,94,185,.508,0,0,,94,185,.508,.508,68,105,.648,145,359,504,139,50,197,76,296,256
1990,Michael Jordan*,SG,26,CHI,82,82,3197,1034,1964,.526,92,245,.376,942,1719,.548,.550,593,699,.848,143,422,565,519,227,54,247,241,2753
1990,Shawn Kemp,PF,20,SEA,81,1,1120,203,424,.479,2,12,.167,201,412,.488,.481,117,159,.736,146,200,346,26,47,70,107,204,525
1990,Tim Kempton,PF,26,DEN,71,14,1061,153,312,.490,0,1,.000,153,311,.492,.490,77,114,.675,51,167,218,118,30,9,80,144,383
1990,Steve Kerr,PG,24,CLE,78,5,1664,192,432,.444,73,144,.507,119,288,.413,.529,63,73,.863,12,86,98,248,45,7,74,59,520
1990,Jerome Kersey,SF,27,POR,82,82,2843,519,1085,.478,3,20,.150,516,1065,.485,.480,269,390,.690,251,439,690,188,121,63,144,304,1310
1990,Randolph Keys,SF,23,TOT,80,18,1615,293,678,.432,14,43,.326,279,635,.439,.442,101,140,.721,100,153,253,88,68,8,84,224,701
1990,Randolph Keys,SF,23,CLE,48,13,892,151,359,.421,2,10,.200,149,349,.427,.423,61,82,.744,52,85,137,39,38,2,47,117,365
1990,Randolph Keys,SF,23,CHH,32,5,723,142,319,.445,12,33,.364,130,286,.455,.464,40,58,.690,48,68,116,49,30,6,37,107,336
1990,Stan Kimbrough,PG,23,DET,10,0,50,7,16,.438,0,0,,7,16,.438,.438,2,2,1.000,4,3,7,5,4,0,4,4,16
1990,Bernard King*,SF,33,WSB,82,82,2687,711,1459,.487,3,23,.130,708,1436,.493,.488,412,513,.803,129,275,404,376,51,7,248,230,1837
1990,Stacey King,PF,23,CHI,82,2,1777,267,530,.504,0,1,.000,267,529,.505,.504,194,267,.727,169,215,384,87,38,58,119,215,728
1990,Greg Kite,C,28,SAC,71,47,1515,101,234,.432,1,1,1.000,100,233,.429,.434,27,54,.500,131,246,377,76,31,51,76,201,230
1990,Joe Kleine,C,28,BOS,81,4,1365,176,367,.480,0,4,.000,176,363,.485,.480,83,100,.830,117,238,355,46,15,27,64,170,435
1990,Jon Koncak,C,26,ATL,54,28,977,78,127,.614,0,1,.000,78,126,.619,.614,42,79,.532,58,168,226,23,38,34,47,182,198
1990,Frank Kornet,PF,23,MIL,57,0,438,42,114,.368,5,20,.250,37,94,.394,.390,24,39,.615,25,46,71,21,14,3,23,54,113
1990,Larry Krystkowiak,PF,25,MIL,16,7,381,43,118,.364,0,2,.000,43,116,.371,.364,26,33,.788,16,60,76,25,10,2,19,41,112
1990,Bill Laimbeer,C,32,DET,81,81,2675,380,785,.484,57,158,.361,323,627,.515,.520,164,192,.854,166,614,780,171,57,84,98,278,981
1990,Jerome Lane,PF,23,DEN,67,46,956,145,309,.469,0,5,.000,145,304,.477,.469,44,120,.367,144,217,361,105,53,17,85,189,334
1990,Andrew Lang,C,23,PHO,74,0,1011,97,174,.557,0,0,,97,174,.557,.557,64,98,.653,83,188,271,21,22,133,41,171,258
1990,Jeff Lebo,SG,23,SAS,4,0,32,2,7,.286,0,0,,2,7,.286,.286,2,2,1.000,2,2,4,3,2,0,1,7,6
1990,Eric Leckner,C,23,UTA,77,0,764,125,222,.563,0,0,,125,222,.563,.563,81,109,.743,48,144,192,19,15,23,63,157,331
1990,Tim Legler,SG,23,PHO,11,0,83,11,29,.379,0,1,.000,11,28,.393,.379,6,6,1.000,4,4,8,6,2,0,4,12,28
1990,Gary Leonard,C,22,MIN,22,0,127,13,31,.419,0,1,.000,13,30,.433,.419,6,14,.429,10,17,27,1,3,9,8,26,32
1990,Jim Les,PG,26,TOT,7,0,92,5,14,.357,0,1,.000,5,13,.385,.357,13,17,.765,3,4,7,21,3,0,10,9,23
1990,Jim Les,PG,26,UTA,1,0,6,0,0,,0,0,,0,0,,,2,4,.500,0,0,0,1,0,0,3,3,2
1990,Jim Les,PG,26,LAC,6,0,86,5,14,.357,0,1,.000,5,13,.385,.357,11,13,.846,3,4,7,20,3,0,7,6,21
1990,Clifford Lett,PG,24,CHI,4,0,28,2,8,.250,0,0,,2,8,.250,.250,0,0,,0,0,0,1,0,0,2,8,4
1990,Fat Lever,SG,29,DEN,79,79,2832,568,1283,.443,36,87,.414,532,1196,.445,.457,271,337,.804,230,504,734,517,168,13,156,172,1443
1990,Cliff Levingston,PF,29,ATL,75,5,1706,216,424,.509,1,5,.200,215,419,.513,.511,83,122,.680,113,206,319,80,55,41,49,216,516
1990,Ralph Lewis,SG-SF,26,TOT,7,0,26,4,7,.571,0,0,,4,7,.571,.571,2,2,1.000,4,2,6,0,1,0,2,3,10
1990,Ralph Lewis,SG,26,DET,4,0,6,0,1,.000,0,0,,0,1,.000,.000,0,0,,0,0,0,0,0,0,1,1,0
1990,Ralph Lewis,SF,26,CHH,3,0,20,4,6,.667,0,0,,4,6,.667,.667,2,2,1.000,4,2,6,0,1,0,1,2,10
1990,Reggie Lewis,SG,24,BOS,79,54,2522,540,1089,.496,4,15,.267,536,1074,.499,.498,256,317,.808,109,238,347,225,88,63,120,216,1340
1990,Todd Lichti,SG,23,DEN,79,4,1326,250,514,.486,0,14,.000,250,500,.500,.486,130,174,.747,49,102,151,116,55,13,95,145,630
1990,Alton Lister,C,31,GSW,3,0,40,4,8,.500,0,1,.000,4,7,.571,.500,4,7,.571,5,3,8,2,1,0,0,8,12
1990,Lewis Lloyd,SG,30,TOT,21,0,123,30,53,.566,0,0,,30,53,.566,.566,9,16,.563,8,10,18,11,3,0,20,12,69
1990,Lewis Lloyd,SG,30,PHI,2,0,10,1,2,.500,0,0,,1,2,.500,.500,0,0,,0,0,0,0,0,0,4,3,2
1990,Lewis Lloyd,SG,30,HOU,19,0,113,29,51,.569,0,0,,29,51,.569,.569,9,16,.563,8,10,18,11,3,0,16,9,67
1990,Brad Lohaus,PF,25,TOT,80,41,1943,305,663,.460,47,137,.343,258,526,.490,.495,75,103,.728,98,300,398,168,58,88,109,211,732
1990,Brad Lohaus,PF,25,MIN,28,24,590,94,202,.465,1,16,.063,93,186,.500,.468,21,26,.808,21,89,110,62,14,22,45,66,210
1990,Brad Lohaus,PF,25,MIL,52,17,1353,211,461,.458,46,121,.380,165,340,.485,.508,54,77,.701,77,211,288,106,44,66,64,145,522
1990,Grant Long,PF,23,MIA,81,31,1856,257,532,.483,0,3,.000,257,529,.486,.483,172,241,.714,156,246,402,96,91,38,139,300,686
1990,John Long,SG,33,ATL,48,19,1030,174,384,.453,10,29,.345,164,355,.462,.466,46,55,.836,26,57,83,85,45,5,75,66,404
1990,Sidney Lowe,PG,30,MIN,80,38,1744,73,229,.319,2,9,.222,71,220,.323,.323,39,54,.722,41,122,163,337,73,4,63,114,187
1990,John Lucas,PG,36,HOU,49,18,938,109,291,.375,26,87,.299,83,204,.407,.419,42,55,.764,19,71,90,238,45,2,85,59,286
1990,Rick Mahorn,PF,31,PHI,75,66,2271,313,630,.497,2,9,.222,311,621,.501,.498,183,256,.715,167,401,568,98,44,103,104,251,811
1990,Dan Majerle,SG,24,PHO,73,23,2244,296,698,.424,19,80,.238,277,618,.448,.438,198,260,.762,144,286,430,188,100,32,82,177,809
1990,Jeff Malone,SG,28,WSB,75,74,2567,781,1592,.491,1,6,.167,780,1586,.492,.491,257,293,.877,54,152,206,243,48,6,125,116,1820
1990,Karl Malone*,PF,26,UTA,82,82,3122,914,1627,.562,16,43,.372,898,1584,.567,.567,696,913,.762,232,679,911,226,121,50,304,259,2540
1990,Moses Malone*,C,34,ATL,81,81,2735,517,1077,.480,1,9,.111,516,1068,.483,.481,493,631,.781,364,448,812,130,47,84,232,158,1528
1990,Danny Manning,PF,23,LAC,71,42,2269,440,826,.533,0,5,.000,440,821,.536,.533,274,370,.741,142,280,422,187,91,39,188,261,1154
1990,Roy Marble,SG,23,ATL,24,0,162,16,58,.276,0,2,.000,16,56,.286,.276,19,29,.655,15,9,24,11,7,1,14,16,51
1990,Šarūnas Marčiulionis*,SG,25,GSW,75,3,1695,289,557,.519,10,39,.256,279,518,.539,.528,317,403,.787,84,137,221,121,94,7,137,230,905
1990,Jeff Martin,SG,23,LAC,69,23,1351,170,414,.411,2,15,.133,168,399,.421,.413,91,129,.705,78,81,159,44,41,16,47,97,433
1990,Anthony Mason,PF,23,NJN,21,0,108,14,40,.350,0,0,,14,40,.350,.350,9,15,.600,11,23,34,7,2,2,11,20,37
1990,Wes Matthews,PG,30,ATL,1,0,13,1,3,.333,0,1,.000,1,2,.500,.333,2,2,1.000,0,0,0,5,0,0,0,0,4
1990,Vernon Maxwell,SG,24,TOT,79,12,1987,275,627,.439,28,105,.267,247,522,.473,.461,136,211,.645,50,178,228,296,84,10,143,148,714
1990,Vernon Maxwell,SG,24,SAS,49,2,1118,133,306,.435,15,52,.288,118,254,.465,.459,59,95,.621,35,106,141,146,42,5,71,79,340
1990,Vernon Maxwell,SG,24,HOU,30,10,869,142,321,.442,13,53,.245,129,268,.481,.463,77,116,.664,15,72,87,150,42,5,72,69,374
1990,Bob McCann,SF,25,DAL,10,0,62,7,21,.333,0,0,,7,21,.333,.333,12,14,.857,4,8,12,6,2,2,6,7,26
1990,Mel McCants,SF,22,LAL,13,0,65,8,26,.308,0,0,,8,26,.308,.308,6,8,.750,1,5,6,2,3,1,1,11,22
1990,George McCloud,SF,22,IND,44,0,413,45,144,.313,13,40,.325,32,104,.308,.358,15,19,.789,12,30,42,45,19,3,36,56,118
1990,Tim McCormick,C,27,HOU,18,0,116,10,29,.345,0,0,,10,29,.345,.345,10,19,.526,8,19,27,3,3,1,10,24,30
1990,Rodney McCray,SF,28,SAC,82,82,3238,537,1043,.515,11,42,.262,526,1001,.525,.520,273,348,.784,192,477,669,377,60,70,174,176,1358
1990,Xavier McDaniel,SF,26,SEA,69,67,2432,611,1233,.496,5,17,.294,606,1216,.498,.498,244,333,.733,165,282,447,171,73,36,187,231,1471
1990,Mike McGee,SF,30,PHO,14,7,280,42,87,.483,8,23,.348,34,64,.531,.529,10,21,.476,11,25,36,16,8,1,14,28,102
1990,Kevin McHale*,PF,32,BOS,82,25,2722,648,1181,.549,23,69,.333,625,1112,.562,.558,393,440,.893,201,476,677,172,30,157,183,250,1712
1990,Derrick McKey,SF,23,SEA,80,80,2748,468,949,.493,3,23,.130,465,926,.502,.495,315,403,.782,170,319,489,187,87,81,192,247,1254
1990,Carlton McKinney,SG,25,LAC,7,0,104,8,32,.250,0,1,.000,8,31,.258,.250,2,4,.500,4,8,12,7,6,1,7,15,18
1990,Nate McMillan,SG,25,SEA,82,69,2338,207,438,.473,11,31,.355,196,407,.482,.485,98,153,.641,127,276,403,598,140,37,187,289,523
1990,Mark McNamara,C,30,LAL,33,1,190,38,86,.442,0,0,,38,86,.442,.442,26,40,.650,22,41,63,3,2,1,21,31,102
1990,Scott Meents,PF,26,SEA,26,0,148,19,44,.432,0,0,,19,44,.432,.432,17,23,.739,7,23,30,7,4,3,9,12,55
1990,Reggie Miller*,SG,24,IND,82,82,3192,661,1287,.514,150,362,.414,511,925,.552,.572,544,627,.868,95,200,295,311,110,18,222,175,2016
1990,Sam Mitchell,PF,26,MIN,80,30,2414,372,834,.446,0,9,.000,372,825,.451,.446,268,349,.768,180,282,462,89,66,54,96,301,1012
1990,Paul Mokeski,C,33,CLE,38,1,449,63,150,.420,0,1,.000,63,149,.423,.420,25,36,.694,27,72,99,17,8,10,26,76,151
1990,Johnny Moore,PG,31,SAS,53,8,516,47,126,.373,8,34,.235,39,92,.424,.405,16,27,.593,16,36,52,82,32,3,39,55,118
1990,Chris Morris,SF,24,NJN,80,76,2449,449,1065,.422,61,193,.316,388,872,.445,.450,228,316,.722,194,228,422,143,130,79,185,219,1187
1990,Mike Morrison,SG,22,PHO,36,1,153,23,68,.338,2,7,.286,21,61,.344,.353,24,30,.800,7,13,20,11,2,0,23,20,72
1990,John Morton,SG,22,CLE,37,3,402,48,161,.298,7,30,.233,41,131,.313,.320,43,62,.694,7,25,32,67,18,4,51,30,146
1990,Chris Mullin*,SF,26,GSW,78,78,2830,682,1272,.536,87,234,.372,595,1038,.573,.570,505,568,.889,130,333,463,319,123,45,239,142,1956
1990,Tod Murphy,C,26,MIN,82,59,2493,260,552,.471,16,43,.372,244,509,.479,.486,144,203,.709,207,357,564,106,76,60,61,229,680
1990,Pete Myers,SG,26,TOT,52,2,751,89,225,.396,0,7,.000,89,218,.408,.396,66,100,.660,33,63,96,135,35,11,76,109,244
1990,Pete Myers,SG,26,NYK,24,0,208,15,45,.333,0,1,.000,15,44,.341,.333,16,31,.516,10,18,28,35,15,2,18,39,46
1990,Pete Myers,SG,26,NJN,28,2,543,74,180,.411,0,6,.000,74,174,.425,.411,50,69,.725,23,45,68,100,20,9,58,70,198
1990,Larry Nance,PF,30,CLE,62,53,2065,412,807,.511,1,1,1.000,411,806,.510,.511,186,239,.778,162,354,516,161,54,122,110,185,1011
1990,Calvin Natt,SF,33,IND,14,0,164,20,31,.645,0,0,,20,31,.645,.645,17,22,.773,10,25,35,9,1,0,5,14,57
1990,Ed Nealy,PF,29,CHI,46,0,503,37,70,.529,0,2,.000,37,68,.544,.529,30,41,.732,46,92,138,28,16,4,17,67,104
1990,Chuck Nevitt,C,30,HOU,3,0,9,2,2,1.000,0,0,,2,2,1.000,1.000,0,0,,0,3,3,1,0,1,2,3,4
1990,Johnny Newman,SF,26,NYK,80,69,2277,374,786,.476,45,142,.317,329,644,.511,.504,239,299,.799,60,131,191,180,95,22,143,254,1032
1990,Kurt Nimphius,C,31,PHI,38,1,314,38,91,.418,0,1,.000,38,90,.422,.418,14,30,.467,22,39,61,6,4,18,12,45,90
1990,Dyron Nix,SF,22,IND,20,0,109,14,39,.359,0,0,,14,39,.359,.359,11,16,.688,8,18,26,5,3,1,7,15,39
1990,Ken Norman,SF,25,LAC,70,64,2334,484,949,.510,7,16,.438,477,933,.511,.514,153,242,.632,143,327,470,160,78,59,190,196,1128
1990,Charles Oakley,PF,26,NYK,61,61,2196,336,641,.524,0,3,.000,336,638,.527,.524,217,285,.761,258,469,727,146,64,16,165,220,889
1990,Hakeem Olajuwon*,C,27,HOU,82,82,3124,806,1609,.501,1,6,.167,805,1603,.502,.501,382,536,.713,299,850,1149,234,174,376,316,314,1995
1990,Jawann Oldham,C,32,TOT,6,0,45,3,6,.500,0,0,,3,6,.500,.500,3,7,.429,4,12,16,1,2,3,4,9,9
1990,Jawann Oldham,C,32,ORL,3,0,36,1,3,.333,0,0,,1,3,.333,.333,2,5,.400,4,11,15,0,2,3,3,6,4
1990,Jawann Oldham,C,32,LAL,3,0,9,2,3,.667,0,0,,2,3,.667,.667,1,2,.500,0,1,1,1,0,0,1,3,5
1990,José Ortiz,PF,26,UTA,13,0,64,19,42,.452,1,2,.500,18,40,.450,.464,3,5,.600,8,7,15,7,2,1,5,15,42
1990,Robert Parish*,C,36,BOS,79,78,2396,505,871,.580,0,0,,505,871,.580,.580,233,312,.747,259,537,796,103,38,69,169,189,1243
1990,Žarko Paspalj,SF,23,SAS,28,1,181,27,79,.342,0,1,.000,27,78,.346,.342,18,22,.818,15,15,30,10,3,7,21,37,72
1990,Jim Paxson,PG,32,BOS,72,25,1283,191,422,.453,5,20,.250,186,402,.463,.459,73,90,.811,24,53,77,137,33,5,54,115,460
1990,John Paxson,PG,29,CHI,82,82,2365,365,708,.516,33,92,.359,332,616,.539,.539,56,68,.824,27,92,119,335,83,6,85,176,819
1990,Kenny Payne,SF,23,PHI,35,4,216,47,108,.435,4,10,.400,43,98,.439,.454,16,18,.889,11,15,26,10,7,6,20,37,114
1990,Will Perdue,C,24,CHI,77,11,884,111,268,.414,0,5,.000,111,263,.422,.414,72,104,.692,88,126,214,46,19,26,65,150,294
1990,Sam Perkins,SF,28,DAL,76,70,2668,435,883,.493,6,28,.214,429,855,.502,.496,330,424,.778,209,363,572,175,88,64,148,225,1206
1990,Tim Perry,C,24,PHO,60,18,612,100,195,.513,1,1,1.000,99,194,.510,.515,53,90,.589,79,73,152,17,21,22,47,76,254
1990,Chuck Person,SF,25,IND,77,73,2714,605,1242,.487,94,253,.372,511,989,.517,.525,211,270,.781,126,319,445,230,53,20,170,217,1515
1990,Jim Petersen,C,27,GSW,43,19,592,60,141,.426,0,1,.000,60,140,.429,.426,52,73,.712,49,111,160,23,17,20,36,103,172
1990,Dražen Petrović*,SG,25,POR,77,0,967,207,427,.485,34,74,.459,173,353,.490,.525,135,160,.844,50,61,111,116,23,2,96,134,583
1990,Ricky Pierce,SG,30,MIL,59,0,1709,503,987,.510,46,133,.346,457,854,.535,.533,307,366,.839,64,103,167,133,50,7,129,158,1359
1990,Ed Pinckney,PF,26,BOS,77,50,1082,135,249,.542,0,1,.000,135,248,.544,.542,92,119,.773,93,132,225,68,34,42,56,126,362
1990,Scottie Pippen*,SF,24,CHI,82,82,3148,562,1150,.489,28,112,.250,534,1038,.514,.501,199,295,.675,150,397,547,444,211,101,278,298,1351
1990,Olden Polynice,C,25,SEA,79,7,1085,156,289,.540,1,2,.500,155,287,.540,.542,47,99,.475,128,172,300,15,25,21,35,187,360
1990,Terry Porter,PG,26,POR,80,80,2781,448,969,.462,89,238,.374,359,731,.491,.508,421,472,.892,59,213,272,726,151,4,245,150,1406
1990,Paul Pressey,SG,31,MIL,57,2,1400,239,506,.472,6,43,.140,233,463,.503,.478,144,190,.758,59,113,172,244,71,23,109,149,628
1990,Harold Pressley,SF,26,SAC,72,10,1603,240,566,.424,46,148,.311,194,418,.464,.465,110,141,.780,94,215,309,149,58,36,88,148,636
1990,Mark Price,PG,25,CLE,73,73,2706,489,1066,.459,152,374,.406,337,692,.487,.530,300,338,.888,66,185,251,666,114,5,214,89,1430
1990,Brian Quinnett,SG,23,NYK,31,0,193,19,58,.328,0,2,.000,19,56,.339,.328,2,3,.667,9,19,28,11,3,4,4,27,40
1990,Kurt Rambis,PF,31,TOT,74,61,1904,190,373,.509,0,3,.000,190,370,.514,.509,82,127,.646,156,369,525,135,100,37,104,208,462
1990,Kurt Rambis,PF,31,CHH,16,16,448,58,116,.500,0,1,.000,58,115,.504,.500,30,55,.545,48,72,120,28,32,10,29,45,146
1990,Kurt Rambis,PF,31,PHO,58,45,1456,132,257,.514,0,2,.000,132,255,.518,.514,52,72,.722,108,297,405,107,68,27,75,163,316
1990,Blair Rasmussen,C,27,DEN,81,55,1995,445,895,.497,0,1,.000,445,894,.498,.497,111,134,.828,174,420,594,82,40,104,75,300,1001
1990,J.R. Reid,C,21,CHH,82,82,2757,358,814,.440,0,5,.000,358,809,.443,.440,192,289,.664,199,492,691,101,92,54,172,292,908
1990,Robert Reid,SF,34,TOT,72,28,1202,175,447,.391,10,32,.313,165,415,.398,.403,54,86,.628,34,117,151,90,38,16,45,153,414
1990,Robert Reid,SF,34,POR,12,1,85,13,33,.394,1,3,.333,12,30,.400,.409,4,8,.500,1,7,8,8,2,2,1,17,31
1990,Robert Reid,SF,34,CHH,60,27,1117,162,414,.391,9,29,.310,153,385,.397,.402,50,78,.641,33,110,143,82,36,14,44,136,383
1990,Jerry Reynolds,SF,27,ORL,67,40,1817,309,741,.417,1,14,.071,308,727,.424,.418,239,322,.742,91,232,323,180,93,64,139,162,858
1990,Glen Rice,SF,22,MIA,77,60,2311,470,1071,.439,17,69,.246,453,1002,.452,.447,91,124,.734,100,252,352,138,67,27,113,198,1048
1990,Pooh Richardson,PG,23,MIN,82,48,2581,426,925,.461,23,83,.277,403,842,.479,.473,63,107,.589,55,162,217,554,133,25,141,143,938
1990,Mitch Richmond*,SG,24,GSW,78,78,2799,640,1287,.497,34,95,.358,606,1192,.508,.510,406,469,.866,98,262,360,223,98,24,201,210,1720
1990,David Rivers,PG,25,LAC,52,11,724,80,197,.406,0,5,.000,80,192,.417,.406,59,78,.756,30,55,85,155,31,0,88,53,219
1990,Doc Rivers,PG,28,ATL,48,44,1526,218,480,.454,24,66,.364,194,414,.469,.479,138,170,.812,47,153,200,264,116,22,98,151,598
1990,Fred Roberts,PF,29,MIL,82,66,2235,330,666,.495,2,11,.182,328,655,.501,.497,195,249,.783,107,204,311,147,56,25,130,210,857
1990,Alvin Robertson,SG,27,MIL,81,81,2599,476,946,.503,4,26,.154,472,920,.513,.505,197,266,.741,230,329,559,445,207,17,217,280,1153
1990,Clifford Robinson,PF,23,POR,82,0,1565,298,751,.397,12,44,.273,286,707,.405,.405,138,251,.550,110,198,308,72,53,53,129,226,746
1990,David Robinson*,C,24,SAS,82,81,3002,690,1300,.531,0,2,.000,690,1298,.532,.531,613,837,.732,303,680,983,164,138,319,257,259,1993
1990,Dennis Rodman*,SF,28,DET,82,43,2377,288,496,.581,1,9,.111,287,487,.589,.582,142,217,.654,336,456,792,72,52,60,90,276,719
1990,Tree Rollins,C,34,CLE,48,19,674,57,125,.456,0,1,.000,57,124,.460,.456,11,16,.688,58,95,153,24,13,53,35,83,125
1990,Doug Roth,C,22,WSB,42,0,412,37,86,.430,0,1,.000,37,85,.435,.430,7,14,.500,44,76,120,20,8,13,16,70,81
1990,Scott Roth,SF,26,MIN,71,3,1061,159,420,.379,18,52,.346,141,368,.383,.400,150,201,.746,34,78,112,115,51,6,85,144,486
1990,Jim Rowinski,PF,29,MIA,14,0,112,14,32,.438,0,0,,14,32,.438,.438,22,26,.846,17,12,29,5,1,2,10,19,50
1990,Brian Rowsom,PF,24,CHH,44,2,559,78,179,.436,1,2,.500,77,177,.435,.439,68,83,.819,44,87,131,22,18,11,25,58,225
1990,Donald Royal,SF,23,MIN,66,0,746,117,255,.459,0,1,.000,117,254,.461,.459,153,197,.777,69,68,137,43,32,8,81,107,387
1990,Delaney Rudd,PG,27,UTA,77,2,850,111,259,.429,16,56,.286,95,203,.468,.459,35,53,.660,12,43,55,177,22,1,88,81,273
1990,John Salley,PF,25,DET,82,12,1914,209,408,.512,1,4,.250,208,404,.515,.513,174,244,.713,154,285,439,67,51,153,97,282,593
1990,Ralph Sampson*,C,29,SAC,26,7,417,48,129,.372,1,4,.250,47,125,.376,.376,12,23,.522,11,73,84,28,14,22,34,66,109
1990,Jeff Sanders,PF,24,CHI,31,0,182,13,40,.325,0,0,,13,40,.325,.325,2,4,.500,17,22,39,9,4,4,15,27,28
1990,Mike Sanders,SF,29,IND,82,13,1531,225,479,.470,5,14,.357,220,465,.473,.475,55,75,.733,78,152,230,89,43,23,79,220,510
1990,Danny Schayes,C,30,DEN,53,22,1194,163,330,.494,0,4,.000,163,326,.500,.494,225,264,.852,117,225,342,61,41,45,72,200,551
1990,Detlef Schrempf,PF,27,IND,78,18,2573,424,822,.516,17,48,.354,407,774,.526,.526,402,490,.820,149,471,620,247,59,16,180,271,1267
1990,Byron Scott,SG,28,LAL,77,77,2593,472,1005,.470,93,220,.423,379,785,.483,.516,160,209,.766,51,191,242,274,77,31,122,180,1197
1990,Rony Seikaly,C,24,MIA,74,72,2409,486,968,.502,0,1,.000,486,967,.503,.502,256,431,.594,253,513,766,78,78,124,236,258,1228
1990,Brad Sellers,PF,27,TOT,59,0,700,103,254,.406,0,5,.000,103,249,.414,.406,58,73,.795,39,50,89,33,17,22,46,74,264
1990,Brad Sellers,PF,27,SEA,45,0,587,84,198,.424,0,3,.000,84,195,.431,.424,49,61,.803,31,39,70,32,11,19,34,63,217
1990,Brad Sellers,PF,27,MIN,14,0,113,19,56,.339,0,2,.000,19,54,.352,.339,9,12,.750,8,11,19,1,6,3,12,11,47
1990,Charles Shackleford,C,23,NJN,70,37,1557,247,535,.462,0,1,.000,247,534,.463,.462,79,115,.687,180,299,479,56,40,35,116,183,573
1990,John Shasky,C,25,GSW,14,0,51,4,14,.286,0,0,,4,14,.286,.286,2,6,.333,4,9,13,1,1,2,2,10,10
1990,Purvis Short,SF,32,NJN,82,24,2213,432,950,.455,10,35,.286,422,915,.461,.460,198,237,.835,101,147,248,145,66,20,119,202,1072
1990,Dexter Shouse,PG,26,PHI,3,0,18,0,4,.000,0,1,.000,0,3,.000,.000,0,0,,0,0,0,2,1,1,2,2,0
1990,Jerry Sichting,PG,33,TOT,35,8,496,50,125,.400,3,12,.250,47,113,.416,.412,18,22,.818,3,16,19,94,16,2,22,40,121
1990,Jerry Sichting,PG,33,CHH,34,8,469,50,119,.420,3,12,.250,47,107,.439,.433,15,18,.833,3,16,19,92,16,2,22,39,118
1990,Jerry Sichting,PG,33,MIL,1,0,27,0,6,.000,0,0,,0,6,.000,.000,3,4,.750,0,0,0,2,0,0,0,1,3
1990,Jack Sikma*,C,34,MIL,71,70,2250,344,827,.416,68,199,.342,276,628,.439,.457,230,260,.885,109,383,492,229,76,48,139,244,986
1990,Scott Skiles,PG,25,ORL,70,32,1460,190,464,.409,52,132,.394,138,332,.416,.466,104,119,.874,23,136,159,334,36,4,90,126,536
1990,Charles Smith,PF,24,LAC,78,76,2732,595,1145,.520,1,12,.083,594,1133,.524,.520,454,572,.794,177,347,524,114,86,119,162,294,1645
1990,Charles Smith,PG,22,BOS,60,0,519,59,133,.444,0,7,.000,59,126,.468,.444,53,76,.697,14,55,69,103,35,3,36,75,171
1990,Derek Smith,SF,28,PHI,75,7,1405,261,514,.508,16,36,.444,245,478,.513,.523,130,186,.699,62,110,172,109,35,20,85,198,668
1990,Kenny Smith,PG,24,TOT,79,51,2421,378,811,.466,26,83,.313,352,728,.484,.482,161,196,.821,18,139,157,445,79,8,169,143,943
1990,Kenny Smith,PG,24,SAC,46,46,1747,280,607,.461,22,59,.373,258,548,.471,.479,106,131,.809,11,109,120,303,57,7,122,98,688
1990,Kenny Smith,PG,24,ATL,33,5,674,98,204,.480,4,24,.167,94,180,.522,.490,55,65,.846,7,30,37,142,22,1,47,45,255
1990,Larry Smith,PF,32,HOU,74,0,1300,101,213,.474,0,2,.000,101,211,.479,.474,20,55,.364,180,272,452,69,56,28,70,203,222
1990,Michael Smith,PF,24,BOS,65,7,620,136,286,.476,2,28,.071,134,258,.519,.479,53,64,.828,40,60,100,79,9,1,54,51,327
1990,Otis Smith,SF,26,ORL,65,35,1644,348,708,.492,10,40,.250,338,668,.506,.499,169,222,.761,117,183,300,147,76,57,102,174,875
1990,Rik Smits,C,23,IND,82,82,2404,515,967,.533,0,1,.000,515,966,.533,.533,241,297,.811,135,377,512,142,45,169,143,328,1271
1990,Mike Smrek,C,27,GSW,13,3,107,10,24,.417,0,0,,10,24,.417,.417,1,6,.167,11,23,34,1,4,11,9,18,21
1990,Rory Sparrow,PG,31,MIA,82,25,1756,210,510,.412,8,40,.200,202,470,.430,.420,59,77,.766,37,101,138,298,49,4,99,140,487
1990,John Stockton*,PG,27,UTA,78,78,2915,472,918,.514,47,113,.416,425,805,.528,.540,354,432,.819,57,149,206,1134,207,18,272,233,1345
1990,Greg Stokes,PF,26,SAC,11,0,34,1,9,.111,0,0,,1,9,.111,.111,2,2,1.000,2,3,5,0,0,0,3,8,4
1990,Rod Strickland,PG,23,TOT,82,24,2140,343,756,.454,8,30,.267,335,726,.461,.459,174,278,.626,90,169,259,468,127,14,170,160,868
1990,Rod Strickland,PG,23,NYK,51,0,1019,170,386,.440,6,21,.286,164,365,.449,.448,83,130,.638,43,83,126,219,70,8,85,71,429
1990,Rod Strickland,PG,23,SAS,31,24,1121,173,370,.468,2,9,.222,171,361,.474,.470,91,148,.615,47,86,133,249,57,6,85,89,439
1990,Jon Sundvold,SG,28,MIA,63,2,867,148,363,.408,44,100,.440,104,263,.395,.468,44,52,.846,15,56,71,102,25,0,52,69,384
1990,Roy Tarpley,PF,25,DAL,45,35,1648,314,696,.451,0,6,.000,314,690,.455,.451,130,172,.756,189,400,589,67,79,70,117,160,758
1990,Jay Taylor,SG,22,NJN,17,0,114,21,52,.404,3,13,.231,18,39,.462,.433,6,9,.667,5,6,11,5,5,3,10,9,51
1990,Leonard Taylor,PF,23,GSW,10,0,37,0,6,.000,0,1,.000,0,5,.000,.000,11,16,.688,4,8,12,1,0,0,5,4,11
1990,Terry Teagle,SF,29,GSW,82,49,2376,538,1122,.480,3,14,.214,535,1108,.483,.481,244,294,.830,114,253,367,155,91,15,144,231,1323
1990,Reggie Theus,SG,32,ORL,76,71,2350,517,1178,.439,26,105,.248,491,1073,.458,.450,378,443,.853,75,146,221,407,60,12,226,194,1438
1990,Isiah Thomas*,PG,28,DET,81,81,2993,579,1322,.438,42,136,.309,537,1186,.453,.454,292,377,.775,74,234,308,765,139,19,322,206,1492
1990,Billy Thompson,SF,26,MIA,79,45,2142,375,727,.516,2,4,.500,373,723,.516,.517,115,185,.622,238,313,551,166,54,89,156,237,867
1990,LaSalle Thompson,C,28,IND,82,60,2126,223,471,.473,1,5,.200,222,466,.476,.475,107,134,.799,175,455,630,106,65,71,150,313,554
1990,Mychal Thompson,C,35,LAL,70,70,1883,281,562,.500,0,0,,281,562,.500,.500,144,204,.706,173,304,477,43,33,73,79,207,706
1990,Bob Thornton,PF,27,PHI,56,0,592,48,112,.429,1,3,.333,47,109,.431,.433,26,51,.510,45,88,133,17,20,12,35,105,123
1990,Otis Thorpe,PF,27,HOU,82,82,2947,547,998,.548,0,10,.000,547,988,.554,.548,307,446,.688,258,476,734,261,66,24,229,270,1401
1990,Sedale Threatt,PG,28,SEA,65,18,1481,303,599,.506,8,32,.250,295,567,.520,.513,130,157,.828,43,72,115,216,65,8,77,164,744
1990,Wayman Tisdale,PF,25,SAC,79,79,2937,726,1383,.525,0,6,.000,726,1377,.527,.525,306,391,.783,185,410,595,108,54,54,153,251,1758
1990,Tom Tolbert,PF,24,GSW,70,21,1347,218,442,.493,5,18,.278,213,424,.502,.499,175,241,.726,122,241,363,58,23,25,79,191,616
1990,Sedric Toney,PG,27,TOT,64,9,968,87,250,.348,23,63,.365,64,187,.342,.394,67,83,.807,14,46,60,174,33,0,73,106,264
1990,Sedric Toney,PG,27,ATL,32,0,286,30,72,.417,7,13,.538,23,59,.390,.465,21,25,.840,3,11,14,52,10,0,21,35,88
1990,Sedric Toney,PG,27,SAC,32,9,682,57,178,.320,16,50,.320,41,128,.320,.365,46,58,.793,11,35,46,122,23,0,52,71,176
1990,Kelly Tripucka,SF,30,CHH,79,73,2404,442,1029,.430,38,104,.365,404,925,.437,.448,310,351,.883,82,240,322,224,75,16,176,220,1232
1990,Trent Tucker,SG,30,NYK,81,2,1725,253,606,.417,95,245,.388,158,361,.438,.496,66,86,.767,57,117,174,173,74,8,73,159,667
1990,Andre Turner,PG,25,TOT,11,0,115,11,38,.289,0,2,.000,11,36,.306,.289,4,4,1.000,4,4,8,23,8,0,12,6,26
1990,Andre Turner,PG,25,LAC,3,0,31,2,13,.154,0,1,.000,2,12,.167,.154,0,0,,3,2,5,3,1,0,4,1,4
1990,Andre Turner,PG,25,CHH,8,0,84,9,25,.360,0,1,.000,9,24,.375,.360,4,4,1.000,1,2,3,20,7,0,8,5,22
1990,Henry Turner,PF,23,SAC,36,1,315,58,122,.475,0,3,.000,58,119,.487,.475,40,65,.615,22,28,50,22,17,7,26,40,156
1990,Jeff Turner,PF,27,ORL,60,15,1105,132,308,.429,2,10,.200,130,298,.436,.432,42,54,.778,52,175,227,53,23,12,61,161,308
1990,Melvin Turpin,C,29,WSB,59,12,818,110,209,.526,0,2,.000,110,207,.531,.526,56,71,.789,88,133,221,27,15,47,45,135,276
1990,Kelvin Upshaw,SG,27,TOT,40,0,387,64,146,.438,4,15,.267,60,131,.458,.452,28,37,.757,9,32,41,54,27,1,27,53,160
1990,Kelvin Upshaw,SG,27,BOS,14,0,131,12,39,.308,2,5,.400,10,34,.294,.333,4,6,.667,3,10,13,28,2,1,12,19,30
1990,Kelvin Upshaw,SG,27,DAL,3,0,4,1,3,.333,0,1,.000,1,2,.500,.333,0,0,,0,0,0,0,0,0,0,0,2
1990,Kelvin Upshaw,SG,27,GSW,23,0,252,51,104,.490,2,9,.222,49,95,.516,.500,24,31,.774,6,22,28,26,25,0,15,34,128
1990,Kiki Vandeweghe,SF,31,NYK,22,13,563,102,231,.442,10,19,.526,92,212,.434,.463,44,48,.917,15,38,53,41,15,3,26,28,258
1990,Jay Vincent,SF,30,TOT,41,6,459,86,183,.470,1,2,.500,85,181,.470,.473,41,49,.837,20,42,62,18,18,5,33,52,214
1990,Jay Vincent,SF,30,PHI,17,5,259,45,105,.429,1,1,1.000,44,104,.423,.433,33,37,.892,13,23,36,8,10,2,14,23,124
1990,Jay Vincent,SF,30,LAL,24,1,200,41,78,.526,0,1,.000,41,77,.532,.526,8,12,.667,7,19,26,10,8,3,19,29,90
1990,Sam Vincent,PG,26,ORL,63,45,1657,258,564,.457,1,14,.071,257,550,.467,.458,188,214,.879,37,157,194,354,65,20,132,108,705
1990,Gary Voce,PF,24,CLE,1,0,4,1,3,.333,0,0,,1,3,.333,.333,0,0,,2,0,2,0,0,0,0,0,2
1990,Alexander Volkov,C,25,ATL,72,4,937,137,284,.482,13,34,.382,124,250,.496,.505,70,120,.583,52,67,119,83,36,22,52,166,357
1990,Mark Wade,PG,24,DAL,1,0,3,0,0,,0,0,,0,0,,,0,0,,0,0,0,2,0,0,0,0,0
1990,Darrell Walker,PG,28,WSB,81,81,2883,316,696,.454,2,21,.095,314,675,.465,.455,138,201,.687,173,541,714,652,139,30,173,220,772
1990,Kenny Walker,PF,25,NYK,68,21,1595,204,384,.531,2,5,.400,202,379,.533,.534,125,173,.723,131,212,343,49,33,52,60,178,535
1990,Spud Webb,PG,26,ATL,82,46,2184,294,616,.477,1,19,.053,293,597,.491,.478,162,186,.871,38,163,201,477,105,12,141,185,751
1990,Chris Welp,C,26,TOT,27,3,198,23,61,.377,0,0,,23,61,.377,.377,19,25,.760,18,30,48,9,6,8,15,58,65
1990,Chris Welp,C,26,SAS,13,1,56,7,23,.304,0,0,,7,23,.304,.304,1,2,.500,7,5,12,5,1,0,6,21,15
1990,Chris Welp,C,26,GSW,14,2,142,16,38,.421,0,0,,16,38,.421,.421,18,23,.783,11,25,36,4,5,8,9,37,50
1990,Bill Wennington,C,26,DAL,60,2,814,105,234,.449,0,4,.000,105,230,.457,.449,60,75,.800,64,134,198,41,20,21,50,144,270
1990,Doug West,SG,22,MIN,52,0,378,53,135,.393,3,11,.273,50,124,.403,.404,26,32,.813,24,46,70,18,10,6,31,61,135
1990,Mark West,C,29,PHO,82,79,2399,331,530,.625,0,0,,331,530,.625,.625,199,288,.691,212,516,728,45,36,184,126,277,861
1990,Randy White,PF,22,DAL,55,2,707,93,252,.369,1,14,.071,92,238,.387,.371,50,89,.562,78,95,173,21,24,6,47,124,237
1990,Mitchell Wiggins,SG,30,HOU,66,52,1852,416,853,.488,0,3,.000,416,850,.489,.488,192,237,.810,133,153,286,104,85,1,87,165,1024
1990,Morlon Wiley,PG,23,ORL,40,2,638,92,208,.442,17,46,.370,75,162,.463,.483,28,38,.737,13,39,52,114,45,3,63,65,229
1990,Dominique Wilkins*,SF,30,ATL,80,79,2888,810,1672,.484,59,183,.322,751,1489,.504,.502,459,569,.807,217,304,521,200,126,47,174,141,2138
1990,Eddie Lee Wilkins,C,27,NYK,79,0,972,141,310,.455,0,2,.000,141,308,.458,.455,89,147,.605,114,151,265,16,18,18,73,152,371
1990,Gerald Wilkins,SG,26,NYK,82,80,2609,472,1032,.457,39,125,.312,433,907,.477,.476,208,259,.803,133,238,371,330,95,21,194,188,1191
1990,Buck Williams,PF,29,POR,82,82,2801,413,754,.548,0,1,.000,413,753,.548,.548,288,408,.706,250,550,800,116,69,39,168,285,1114
1990,Herb Williams,C,31,DAL,81,19,2199,295,665,.444,2,9,.222,293,656,.447,.445,108,159,.679,76,315,391,119,51,106,106,243,700
1990,Hot Rod Williams,PF,27,CLE,82,29,2776,528,1070,.493,0,0,,528,1070,.493,.493,325,440,.739,220,443,663,168,86,167,143,214,1381
1990,John Williams,SF,23,WSB,18,18,632,130,274,.474,2,18,.111,128,256,.500,.478,65,84,.774,27,109,136,84,21,9,43,33,327
1990,Micheal Williams,PG,23,TOT,28,1,329,60,119,.504,0,3,.000,60,116,.517,.504,36,46,.783,12,20,32,81,22,1,33,39,156
1990,Micheal Williams,PG,23,PHO,6,0,26,2,10,.200,0,0,,2,10,.200,.200,1,2,.500,1,0,1,4,0,0,5,0,5
1990,Micheal Williams,PG,23,CHH,22,1,303,58,109,.532,0,3,.000,58,106,.547,.532,35,44,.795,11,20,31,77,22,1,28,39,151
1990,Mike Williams,PF-SF,26,TOT,21,0,102,6,18,.333,0,1,.000,6,17,.353,.333,3,6,.500,5,18,23,2,3,7,3,30,15
1990,Mike Williams,PF,26,SAC,16,0,88,6,14,.429,0,1,.000,6,13,.462,.429,3,6,.500,5,17,22,2,3,7,3,28,15
1990,Mike Williams,SF,26,ATL,5,0,14,0,4,.000,0,0,,0,4,.000,.000,0,0,,0,1,1,0,0,0,0,2,0
1990,Reggie Williams,SF,25,TOT,47,17,743,131,338,.388,6,37,.162,125,301,.415,.396,52,68,.765,28,55,83,53,32,14,45,102,320
1990,Reggie Williams,SF,25,LAC,5,5,133,21,57,.368,0,5,.000,21,52,.404,.368,18,21,.857,8,7,15,10,9,1,9,7,60
1990,Reggie Williams,SF,25,CLE,32,12,542,91,239,.381,6,27,.222,85,212,.401,.393,30,41,.732,17,43,60,38,22,10,32,79,218
1990,Reggie Williams,SF,25,SAS,10,0,68,19,42,.452,0,5,.000,19,37,.514,.452,4,6,.667,3,5,8,5,1,3,4,16,42
1990,Kevin Willis,PF,27,ATL,81,51,2273,418,805,.519,2,7,.286,416,798,.521,.520,168,246,.683,253,392,645,57,63,47,144,259,1006
1990,David Wingate,SG,26,SAS,78,2,1856,220,491,.448,0,13,.000,220,478,.460,.448,87,112,.777,62,133,195,208,89,18,127,154,527
1990,Randy Wittman,SF,30,IND,61,0,544,62,122,.508,1,2,.500,61,120,.508,.512,5,6,.833,4,26,30,39,7,4,23,21,130
1990,Joe Wolf,C,25,LAC,77,19,1325,155,392,.395,5,25,.200,150,367,.409,.402,55,71,.775,63,169,232,62,30,24,77,129,370
1990,Leon Wood,SG,27,NJN,28,2,200,16,49,.327,4,21,.190,12,28,.429,.367,14,16,.875,1,11,12,47,6,0,8,16,50
1990,Mike Woodson,SG,31,HOU,61,11,972,160,405,.395,12,41,.293,148,364,.407,.410,62,86,.721,25,63,88,66,42,11,49,100,394
1990,Orlando Woolridge,SF,30,LAL,62,2,1421,306,550,.556,0,5,.000,306,545,.561,.556,176,240,.733,49,136,185,96,39,46,73,160,788
1990,Haywoode Workman,PG,24,ATL,6,0,16,2,3,.667,0,0,,2,3,.667,.667,2,2,1.000,0,3,3,2,3,0,0,3,6
1990,James Worthy*,SF,28,LAL,80,80,2960,711,1298,.548,15,49,.306,696,1249,.557,.554,248,317,.782,160,318,478,288,99,49,160,190,1685
1990,Danny Young,PG,27,POR,82,8,1393,138,328,.421,16,59,.271,122,269,.454,.445,91,112,.813,29,93,122,231,82,4,80,84,383
1990,Michael Young,SF,29,LAC,45,2,459,92,194,.474,8,26,.308,84,168,.500,.495,27,38,.711,36,50,86,24,25,3,15,47,219
